1	१
1027	१०२७
1061	१०६१
11	११
110	११०
110102	११०१०२
112	११२
1124	११२४
1139	११३९
1143	११४३
1144	११४४
1148	११४८
1152	११५२
115385	११५३८५
12	१२
1202	१२०२
1203	१२०३
1205	१२०५
1221	१२२१
1228	१२२८
1234	१२३४
1236	१२३६
1238	१२३८
1239	१२३९
1274	१२७४
13	१३
1343	१३४३
149	१४९
1516	१५१६
153154	१५३१५४
163	१६३
16667	१६६६७
1avidūrenidānakathā	१अविदूरेनिदानकथा
2133	२१३३
2209	२२०९
2218	२२१८
2399	२३९९
259	२५९
27	२७
291	२९१
3	३
303	३०३
3100	३१००
3113	३११३
3200	३२००
3384	३३८४
366	३६६
370	३७०
407	४०७
4129	४१२९
417	४१७
442	४४२
45	४५
477	४७७
511	५११
5195	५१९५
558	५५८
720	७२०
75	७५
751	७५१
8	८
85	८५
99	९९
Abbhantaramhi	अब्भन्तरम्हि
Abbocchinnaṃ	अब्बोच्छिन्नं
Abhidhammakathāmaggaṃ	अभिधम्मकथामग्गं
Abhidhammapiṭake	अभिधम्मपिटके
Abhidhammassa	अभिधम्मस्स
Abhidhammasuttaṃ	अभिधम्मसुत्तं
Abhidhammaṃ	अभिधम्मं
Abhidhamme	अभिधम्मे
Abhidhammo	अभिधम्मो
Abhikkantena	अभिक्कन्तेन
Abhiññābalamāhari	अभिञ्ञाबलमाहरि
Acetanaṃva	अचेतनंव
Acetanāyaṃ	अचेतनायं
Adaṃsu	अदंसु
Adhiṭṭhānapāramitaṃ	अधिट्ठानपारमितं
Advejjhavacanā	अद्वेज्झवचना
Ahampi	अहम्पि
Ahaṃ	अहं
Ahu	अहु
Ajapālarukkhamūle	अजपालरुक्खमूले
Ajaraṃ	अजरं
Ajjhāyako	अज्झायको
Akkamitvāna	अक्कमित्वान
Akāsabhūtā	अकासभूता
Alaṅkatasīsaṃ	अलङ्कतसीसं
Alīnavīriyo	अलीनवीरियो
Amaraṃ	अमरं
Amhākampi	अम्हाकम्पि
Ananto	अनन्तो
Anekaguṇasampannaṃ	अनेकगुणसम्पन्नं
Anekajātisaṃsāraṃ	अनेकजातिसंसारं
Anekakoṭisannicayo	अनेककोटिसन्निचयो
Anekāni	अनेकानि
Aniṭṭhagandho	अनिट्ठगन्धो
Aniṭṭhite	अनिट्ठिते
Anomadassissa	अनोमदस्सिस्स
Anotattadahe	अनोतत्तदहे
Anovaṭṭhena	अनोवट्ठेन
Antalikkhamhi	अन्तलिक्खम्हि
Antarantarā	अन्तरन्तरा
Antobhastagataṃ	अन्तोभस्तगतं
Anuṭṭhāpanīyabhāvo	अनुट्ठापनीयभावो
Anāgatamhi	अनागतम्हि
Anāsavā	अनासवा
Apanetvā	अपनेत्वा
Aparabhāgepi	अपरभागेपि
Aparampissa	अपरम्पिस्स
Aparepi	अपरेपि
Aparimeyye	अपरिमेय्ये
Aparo	अपरो
Apaṇṇakajātakādīni	अपण्णकजातकादीनि
Appattamānasā	अप्पत्तमानसा
Appaṭijagganatā	अप्पटिजग्गनता
Asamo	असमो
Assamo	अस्समो
Assattharukkhamūlamhi	अस्सत्थरुक्खमूलम्हि
Asītihatthamubbedho	असीतिहत्थमुब्बेधो
Atha	अथ
Athassa	अथस्स
Atheko	अथेको
Athāpare	अथापरे
Athāpi	अथापि
Atirekavisesatthadīpako	अतिरेकविसेसत्थदीपको
Atisambādhe	अतिसम्बाधे
Ativisāle	अतिविसाले
Atthato	अत्थतो
Atthaṃ	अत्थं
Attheva	अत्थेव
Atthi	अत्थि
Attho	अत्थो
Atthānaṃ	अत्थानं
Atīradassī	अतीरदस्सी
Avikkhittā	अविक्खित्ता
Avinayadhāritāya	अविनयधारिताय
Avīcimhi	अवीचिम्हि
Ayamettha	अयमेत्थ
Ayameva	अयमेव
Ayampi	अयम्पि
Ayañca	अयञ्च
Ayañhi	अयञ्हि
Ayaṃ	अयं
Aññepi	अञ्ञेपि
Aññesu	अञ्ञेसु
Aṭṭhadhammasamodhānā	अट्ठधम्मसमोधाना
Aṭṭhadosasamākiṇṇaṃ	अट्ठदोससमाकिण्णं
Aṭṭhaguṇasamupeta	अट्ठगुणसमुपेत
Aṭṭhaguṇasamupetaṃ	अट्ठगुणसमुपेतं
Aṭṭhasālinī	अट्ठसालिनी
Aṭṭhimāni	अट्ठिमानि
Aṭṭhīhi	अट्ठीहि
Bahū	बहू
Bandhumatī	बन्धुमती
Bhagavā	भगवा
Bhante	भन्ते
Bhayaṃ	भयं
Bhaṇḍacchedabhayaṃ	भण्डच्छेदभयं
Bhikkhunā	भिक्खुना
Bhikkhāya	भिक्खाय
Bhikkhū	भिक्खू
Bhikkhūnaṃ	भिक्खूनं
Bhojaputte	भोजपुत्ते
Bilāsayā	बिलासया
Bodhaneyyaṃ	बोधनेय्यं
Bodhi	बोधि
Brahmadatto	ब्रह्मदत्तो
Brahmajālādicatuttiṃsasuttasaṅgaho	ब्रह्मजालादिचतुत्तिंससुत्तसङ्गहो
Brāhmaṇa	ब्राह्मण
Brāhmaṇo	ब्राह्मणो
Buddhassa	बुद्धस्स
Buddho	बुद्धो
Buddhoti	बुद्धोति
Buddhānañhi	बुद्धानञ्हि
Bāhirakadānañhi	बाहिरकदानञ्हि
Bāvīsatindriyāni	बावीसतिन्द्रियानि
Bāḷhā	बाळ्हा
Cajato	चजतो
Cakkavāḷasahassehi	चक्कवाळसहस्सेहि
Calatā	चलता
Campakaṃ	चम्पकं
Candasūriyatārakarūpadevatuyyānavimānakapparukkhānaṃ	चन्दसूरियतारकरूपदेवतुय्यानविमानकप्परुक्खानं
Caranti	चरन्ति
Cattāri	चत्तारि
Cattāro	चत्तारो
Cattārome	चत्तारोमे
Catunahutādhikadviyojanasatasahassabahalā	चतुनहुताधिकद्वियोजनसतसहस्सबहला
Caturo	चतुरो
Caturāsīti	चतुरासीति
Catutthe	चतुत्थे
Catuttiṃseva	चतुत्तिंसेव
Catūhi	चतूहि
Caṅkamanassa	चङ्कमनस्स
Caṅkamaṃ	चङ्कमं
Cha	छ
Chanahutādhikanavayojanasatasahassabahalo	छनहुताधिकनवयोजनसतसहस्सबहलो
Chavito	छवितो
Chaḍḍayitvāna	छड्डयित्वान
Cittapariyādānasuttādinavasuttasahassapañcasatasattapaññāsasuttasaṅgaho	चित्तपरियादानसुत्तादिनवसुत्तसहस्सपञ्चसतसत्तपञ्ञाससुत्तसङ्गहो
Cittasamuṭṭhānā	चित्तसमुट्ठाना
Cittassa	चित्तस्स
Cittavibhatti	चित्तविभत्ति
Citto	चित्तो
Cittuppādakaṇḍa	चित्तुप्पादकण्ड
Cittuppādakaṇḍo	चित्तुप्पादकण्डो
Cutī	चुती
Cūḷavedallamahāvedallasammādiṭṭhisakkapañhasaṅkhārabhājanīyamahāpuṇṇamasuttādayo	चूळवेदल्लमहावेदल्लसम्मादिट्ठिसक्कपञ्हसङ्खारभाजनीयमहापुण्णमसुत्तादयो
Dabbasambhāre	दब्बसम्भारे
Dadāhi	ददाहि
Dasahi	दसहि
Dasasahassilokamhi	दससहस्सिलोकम्हि
Dasasahassī	दससहस्सी
Dasavidho	दसविधो
Dasavīsasahassānaṃ	दसवीससहस्सानं
Dassanaṃ	दस्सनं
Dayāya	दयाय
Daḷhaṃ	दळ्हं
Desanā	देसना
Desanānidānaṃ	देसनानिदानं
Desanāsāsanakathābhedaṃ	देसनासासनकथाभेदं
Devatā	देवता
Devatāsaṃyuttādivasena	देवतासंयुत्तादिवसेन
Devā	देवा
Dhammahadayavibhaṅgo	धम्महदयविभङ्गो
Dhammanāvaṃ	धम्मनावं
Dhammapadabhāṇakā	धम्मपदभाणका
Dhammapadaṃ	धम्मपदं
Dhammappaṭiggāhakā	धम्मप्पटिग्गाहका
Dhammasaṅgaṇīaṭṭhakathā	धम्मसङ्गणीअट्ठकथा
Dhammasaṅgaṇīādīni	धम्मसङ्गणीआदीनि
Dhammasenāpatisāriputtattherappabhavā	धम्मसेनापतिसारिपुत्तत्थेरप्पभवा
Dhammasenāpatisāriputtattheropi	धम्मसेनापतिसारिपुत्तत्थेरोपि
Dhammatejena	धम्मतेजेन
Dhammaṃ	धम्मं
Dhamme	धम्मे
Dhammo	धम्मो
Dhammātirekadhammavisesaṭṭhena	धम्मातिरेकधम्मविसेसट्ठेन
Dhunanto	धुनन्तो
Dibbasaṅgītivattanakālo	दिब्बसङ्गीतिवत्तनकालो
Dibbaṃ	दिब्बं
Disodisaṃ	दिसोदिसं
Divā	दिवा
Diyaḍḍhasatasuttantā	दियड्ढसतसुत्तन्ता
Duggahitattā	दुग्गहितत्ता
Dukasataṃ	दुकसतं
Dukatikañceva	दुकतिकञ्चेव
Duke	दुके
Dukkho	दुक्खो
Dutiye	दुतिये
Dutiyābhisamaye	दुतियाभिसमये
Dvepi	द्वेपि
Dvādasaguṇamupāgata	द्वादसगुणमुपागत
Dvādasapadikaṃ	द्वादसपदिकं
Dvādasaterasayojanappamāṇaṃ	द्वादसतेरसयोजनप्पमाणं
Dvādasaterasayojanappamāṇo	द्वादसतेरसयोजनप्पमाणो
Dvādasāyatanāni	द्वादसायतनानि
Dvāsaṭṭhi	द्वासट्ठि
Dvāsīti	द्वासीति
Dvāvīsatitike	द्वावीसतितिके
Dānapāramitaṃ	दानपारमितं
Dānena	दानेन
Dīghappamāṇānaṃ	दीघप्पमाणानं
Dīpaṅkarassa	दीपङ्करस्स
Dīpaṅkaraṃ	दीपङ्करं
Dīpaṅkaro	दीपङ्करो
Ekadvinnaṃ	एकद्विन्नं
Ekamekasmiñcettha	एकमेकस्मिञ्चेत्थ
Ekantena	एकन्तेन
Ekarājajātake	एकराजजातके
Ekaṃ	एकं
Ekekaaṅgātirekavasena	एकेकअङ्गातिरेकवसेन
Ekuttariyaṃ	एकुत्तरियं
Esa	एस
Eso	एसो
Esānisaṃso	एसानिसंसो
Ettakaṃ	एत्तकं
Ettakesu	एत्तकेसु
Ettako	एत्तको
Ettakāyeva	एत्तकायेव
Ettha	एत्थ
Ettāvatā	एत्तावता
Evamassa	एवमस्स
Evametaṃ	एवमेतं
Evametesu	एवमेतेसु
Evameva	एवमेव
Evamevāhaṃ	एवमेवाहं
Evampi	एवम्पि
Evamādīni	एवमादीनि
Evaṃ	एवं
Evāhaṃ	एवाहं
Gahakāraka	गहकारक
Gahakāraṃ	गहकारं
Gahetabbaṃ	गहेतब्बं
Gambhīraṃ	गम्भीरं
Ganthārambhakathā	गन्थारम्भकथा
Gavapānanti	गवपानन्ति
Ghaṭānekasahassāni	घटानेकसहस्सानि
Gāmavāsī	गामवासी
Gāmaṇḍalā	गामण्डला
Gāthābandhesu	गाथाबन्धेसु
Handa	हन्द
Hatthisaddaṃ	हत्थिसद्दं
Haṭṭhatuṭṭhena	हट्ठतुट्ठेन
Heṭṭhā	हेट्ठा
Himavantassāvidūre	हिमवन्तस्साविदूरे
Icchamāno	इच्छमानो
Idaṃ	इदं
Idha	इध
Idāni	इदानि
Imasmiṃ	इमस्मिं
Imassa	इमस्स
Imassāpi	इमस्सापि
Imañhi	इमञ्हि
Imaṃ	इमं
Ime	इमे
Imehi	इमेहि
Imesu	इमेसु
Iminā	इमिना
Imāni	इमानि
Indriyavibhaṅge	इन्द्रियविभङ्गे
Itaraṃ	इतरं
Iti	इति
Ito	इतो
Itthibhāvaṃ	इत्थिभावं
Jalitvā	जलित्वा
Jambudīpā	जम्बुदीपा
Jhānavibhaṅgo	झानविभङ्गो
Jotayitvāna	जोतयित्वान
Jātidhammo	जातिधम्मो
Jāyamānā	जायमाना
Kadā	कदा
Kakusandhassa	ककुसन्धस्स
Kalale	कलले
Kammaṭṭhānāni	कम्मट्ठानानि
Kappe	कप्पे
Karuṇā	करुणा
Kasmā	कस्मा
Kassa	कस्स
Kassaci	कस्सचि
Kassatthāya	कस्सत्थाय
Katamo	कतमो
Katamā	कतमा
Kataraṃ	कतरं
Katañjalī	कतञ्जली
Kathaṃ	कथं
Kathāvatthunāva	कथावत्थुनाव
Kattha	कत्थ
Kañci	कञ्चि
Ke	के
Kehi	केहि
Kena	केन
Kenābhato	केनाभतो
Kenābhatoti	केनाभतोति
Kenādhigato	केनाधिगतो
Kesamassūhi	केसमस्सूहि
Kese	केसे
Kevalañhettha	केवलञ्हेत्थ
Kevalañhi	केवलञ्हि
Khandhānañca	खन्धानञ्च
Khantipāramitaṃ	खन्तिपारमितं
Khantivādījātake	खन्तिवादीजातके
Khaṇena	खणेन
Khemā	खेमा
Khuddakapāṭhadhammapadaudānaitivuttakasuttanipātavimānavatthupetavatthutheragāthātherīgāthājātakaniddesapaṭisambhidāapadānabuddhavaṃsacariyāpiṭakavasena	खुद्दकपाठधम्मपदउदानइतिवुत्तकसुत्तनिपातविमानवत्थुपेतवत्थुथेरगाथाथेरीगाथाजातकनिद्देसपटिसम्भिदाअपदानबुद्धवंसचरियापिटकवसेन
Khuddakavatthuvibhaṅgopi	खुद्दकवत्थुविभङ्गोपि
Khādatha	खादथ
Khīṇāsavehi	खीणासवेहि
Khīṇāsavā	खीणासवा
Kimatthaṃ	किमत्थं
Kisāgotamiyā	किसागोतमिया
Kiṃ	किं
Kolito	कोलितो
Koṇe	कोणे
Koṇḍaññabuddhassa	कोण्डञ्ञबुद्धस्स
Koṭisatasahassasaṅkhyānaṃ	कोटिसतसहस्ससङ्ख्यानं
Koṭisatasahassānaṃ	कोटिसतसहस्सानं
Kulāni	कुलानि
Kusalattikādayo	कुसलत्तिकादयो
Kuṭṭā	कुट्टा
Kālo	कालो
Kāsirāje	कासिराजे
Kāyikavācasikaajjhācāranisedhanato	कायिकवाचसिकअज्झाचारनिसेधनतो
Lakkhaṇe	लक्खणे
Latā	लता
Lomahaṃsajātake	लोमहंसजातके
Madhupiṇḍikasuttantasmiñhi	मधुपिण्डिकसुत्तन्तस्मिञ्हि
Mahaggatā	महग्गता
Mahantaṃ	महन्तं
Mahesakkhā	महेसक्खा
Mahesinā	महेसिना
Mahābodhipallaṅkasmiñhi	महाबोधिपल्लङ्कस्मिञ्हि
Mahādhammahadayaṃ	महाधम्महदयं
Mahādhammahadaye	महाधम्महदये
Mahādhātukathāyaṃ	महाधातुकथायं
Mahāgosiṅgasuttaṃ	महागोसिङ्गसुत्तं
Mahāhanusabhakkhandho	महाहनुसभक्खन्धो
Mahājanā	महाजना
Mahānādaṃ	महानादं
Mahāpakaraṇe	महापकरणे
Mahāpurisassa	महापुरिसस्स
Mahāpuriso	महापुरिसो
Mahārajjaṃ	महारज्जं
Mahāsamuddo	महासमुद्दो
Mahāsatto	महासत्तो
Mahāsutasomajātake	महासुतसोमजातके
Mahāvihāravāsīnaṃ	महाविहारवासीनं
Mahāvātā	महावाता
Majjhimappamāṇāni	मज्झिमप्पमाणानि
Mama	मम
Manussattaṃ	मनुस्सत्तं
Manussāyeva	मनुस्सायेव
Mayampetaṃ	मयम्पेतं
Mañjiṭṭhapabhassarā	मञ्जिट्ठपभस्सरा
Maṃsalohitehi	मंसलोहितेहि
Maṅgalassa	मङ्गलस्स
Maṇḍalārāmavāsī	मण्डलारामवासी
Mettābalenupatthaddho	मेत्ताबलेनुपत्थद्धो
Mettāpāramitaṃ	मेत्तापारमितं
Mettāya	मेत्ताय
Micchādiṭṭhiṃ	मिच्छादिट्ठिं
Mocayitvāna	मोचयित्वान
Mocesiṃ	मोचेसिं
Moggaliputtatissattheropi	मोग्गलिपुत्ततिस्सत्थेरोपि
Mudusamatale	मुदुसमतले
Muttā	मुत्ता
Mā	मा
Mānussakā	मानुस्सका
Mātaraṃ	मातरं
Mātā	माता
Mūgapakkhajātake	मूगपक्खजातके
Mūlapariyāyasuttādidiyaḍḍhasatadvesuttasaṅgaho	मूलपरियायसुत्तादिदियड्ढसतद्वेसुत्तसङ्गहो
Mūlato	मूलतो
Na	न
Nagaraṃ	नगरं
Nagare	नगरे
Nahevaṃ	नहेवं
Namo	नमो
Nandā	नन्दा
Nanu	ननु
Narā	नरा
Nava	नव
Navadosamupāgata	नवदोसमुपागत
Navutikoṭisahassehi	नवुतिकोटिसहस्सेहि
Navutikoṭisahassānaṃ	नवुतिकोटिसहस्सानं
Navutivassasahassāni	नवुतिवस्ससहस्सानि
Nekkhammaninnā	नेक्खम्मनिन्ना
Nekkhammapāramitaṃ	नेक्खम्मपारमितं
Nekkhammābhimukho	नेक्खम्माभिमुखो
Nerañjarāya	नेरञ्जराय
Nibbutā	निब्बुता
Nidānakathā	निदानकथा
Nijjhāmataṇhā	निज्झामतण्हा
Nikkhepakaṇḍa	निक्खेपकण्ड
Nikkhipitvā	निक्खिपित्वा
Nikāyantaraladdhīhi	निकायन्तरलद्धीहि
Nikāyo	निकायो
Nimittāni	निमित्तानि
Nipaccakārassetassa	निपच्चकारस्सेतस्स
Nirayepi	निरयेपि
No	नो
Nāhaṃ	नाहं
Nāmaṃ	नामं
Nānānayavicittassa	नानानयविचित्तस्स
Nāradabuddhassa	नारदबुद्धस्स
Nāthānāthānaṃ	नाथानाथानं
Oghataraṇasuttādisattasuttasahassasattasatadvāsaṭṭhisuttasaṅgaho	ओघतरणसुत्तादिसत्तसुत्तसहस्ससत्तसतद्वासट्ठिसुत्तसङ्गहो
Olokentassevassa	ओलोकेन्तस्सेवस्स
Orohitvāna	ओरोहित्वान
Pabbajitvā	पब्बजित्वा
Pabbajjā	पब्बज्जा
Pabhā	पभा
Paccantadesavisaye	पच्चन्तदेसविसये
Paccanīyapaṭṭhānepi	पच्चनीयपट्ठानेपि
Paccayavasena	पच्चयवसेन
Paccayākāravibhaṅgo	पच्चयाकारविभङ्गो
Pacchābhattaṃ	पच्छाभत्तं
Paccuggamanā	पच्चुग्गमना
Padhānaṃ	पधानं
Padumassa	पदुमस्स
Padumuttarassa	पदुमुत्तरस्स
Padānukkamato	पदानुक्कमतो
Pahāyimaṃ	पहायिमं
Pakaraṇaparicchedato	पकरणपरिच्छेदतो
Pallaṅkena	पल्लङ्केन
Pallaṅkābhujane	पल्लङ्काभुजने
Paribhuñjantassa	परिभुञ्जन्तस्स
Pariggahakaraṇābhāvo	परिग्गहकरणाभावो
Parirakkha	परिरक्ख
Pariyattibhedaṃ	परियत्तिभेदं
Pariyattipi	परियत्तिपि
Pariyesissāmi	परियेसिस्सामि
Pariyosānadivase	परियोसानदिवसे
Passatha	पस्सथ
Pathavisandhārakaṃ	पथविसन्धारकं
Pathaviyaṃ	पथवियं
Pavedhamānā	पवेधमाना
Pañcadosavivajjita	पञ्चदोसविवज्जित
Paññāpāramitaṃ	पञ्ञापारमितं
Paññāya	पञ्ञाय
Paṇḍito	पण्डितो
Paṇṇasālā	पण्णसाला
Paṇṇasālāparibhogasmiñhi	पण्णसालापरिभोगस्मिञ्हि
Paṭhamasannipāte	पठमसन्निपाते
Paṭhame	पठमे
Paṭhamābhisamaye	पठमाभिसमये
Paṭibalo	पटिबलो
Paṭijagganeneva	पटिजग्गनेनेव
Paṭivedho	पटिवेधो
Paṭiyattavaramaggena	पटियत्तवरमग्गेन
Paṭṭhāna	पट्ठान
Phasso	फस्सो
Pitā	पिता
Pitāpi	पितापि
Piyadassissāpi	पियदस्सिस्सापि
Piṭakaṃ	पिटकं
Pubbakehi	पुब्बकेहि
Puna	पुन
Punapariyesanāya	पुनपरियेसनाय
Puthulato	पुथुलतो
Puṇṇamāye	पुण्णमाये
Pāpuṇāti	पापुणाति
Pāramiyo	पारमियो
Pāricchattakamūlamhi	पारिच्छत्तकमूलम्हि
Pāṭihīrāvasānamhi	पाटिहीरावसानम्हि
Pītiyā	पीतिया
Rahogato	रहोगतो
Rajo	रजो
Rogo	रोगो
Rogā	रोगा
Rukkhapathavīpabbatasamuddādayo	रुक्खपथवीपब्बतसमुद्दादयो
Rāhumutto	राहुमुत्तो
Rājābhirājā	राजाभिराजा
Rājārahabhaṇḍatāya	राजारहभण्डताय
Rūpakaṇḍa	रूपकण्ड
Rūpārammaṇaṃ	रूपारम्मणं
Sabbacakkavāḷesu	सब्बचक्कवाळेसु
Sabbameva	सब्बमेव
Sabbampi	सब्बम्पि
Sabbattha	सब्बत्थ
Sabbaññutaññāṇaṃ	सब्बञ्ञुतञ्ञाणं
Sabbaññutaṃ	सब्बञ्ञुतं
Sabbaṃ	सब्बं
Sabbe	सब्बे
Sabbepi	सब्बेपि
Sabbo	सब्बो
Sabbā	सब्बा
Sabbītiyo	सब्बीतियो
Saccapāramitaṃ	सच्चपारमितं
Saccavācaṃ	सच्चवाचं
Saddhammañcassa	सद्धम्मञ्चस्स
Sadevakaṃ	सदेवकं
Saha	सह
Sakalampi	सकलम्पि
Sakalaraṭṭhavāsino	सकलरट्ठवासिनो
Sakalaṃ	सकलं
Sakkhissāmi	सक्खिस्सामि
Sakko	सक्को
Samaye	समये
Samaṃ	समं
Samiddhaṃ	समिद्धं
Sammāsambuddhassa	सम्मासम्बुद्धस्स
Sammāsambuddhena	सम्मासम्बुद्धेन
Sammāsambuddho	सम्मासम्बुद्धो
Sammāsambuddhova	सम्मासम्बुद्धोव
Samokiranti	समोकिरन्ति
Samādayitvā	समादयित्वा
Samūhanivāsā	समूहनिवासा
Sannipātā	सन्निपाता
Sannisinnena	सन्निसिन्नेन
Saraṇāgamane	सरणागमने
Satasahassavassāni	सतसहस्सवस्सानि
Sataṃ	सतं
Satipaṭṭhānavibhaṅgo	सतिपट्ठानविभङ्गो
Satta	सत्त
Sattannaṃ	सत्तन्नं
Sattapaññāsasuttāni	सत्तपञ्ञाससुत्तानि
Sattappakaraṇānīti	सत्तप्पकरणानीति
Sattaratanasampannaṃ	सत्तरतनसम्पन्नं
Satthu	सत्थु
Satthā	सत्था
Satthāpi	सत्थापि
Savati	सवति
Sayaṃ	सयं
Sañcuṇṇamathitā	सञ्चुण्णमथिता
Saṃsaraṃ	संसरं
Saṃsārasotaṃ	संसारसोतं
Saṅghanavakabhikkhunā	सङ्घनवकभिक्खुना
Saṅgītikāle	सङ्गीतिकाले
Saṅgītipariyosāne	सङ्गीतिपरियोसाने
Saṅgītā	सङ्गीता
Saṇhasukhumadhammaṃ	सण्हसुखुमधम्मं
Sekkhā	सेक्खा
Sesaṭṭhānesu	सेसट्ठानेसु
Sikhissāpi	सिखिस्सापि
Sikkhāpadavibhaṅgepi	सिक्खापदविभङ्गेपि
Sikkhāpahānagambhīrabhāvañca	सिक्खापहानगम्भीरभावञ्च
Silāsane	सिलासने
So	सो
Sobhati	सोभति
Somanassañāṇamayikagāthāppaṭisaṃyuttā	सोमनस्सञाणमयिकगाथाप्पटिसंयुत्ता
Sopajja	सोपज्ज
Sopi	सोपि
Sotavekallatā	सोतवेकल्लता
Suddhāvāsesu	सुद्धावासेसु
Suggahitattā	सुग्गहितत्ता
Sukhena	सुखेन
Sumaṅgalo	सुमङ्गलो
Sumedhakathā	सुमेधकथा
Sumedhapaṇḍito	सुमेधपण्डितो
Sumedhassa	सुमेधस्स
Sumedhassāpi	सुमेधस्सापि
Sumedhā	सुमेधा
Supupphitaṃ	सुपुप्फितं
Susāne	सुसाने
Suttantañca	सुत्तन्तञ्च
Suttantañhi	सुत्तन्तञ्हि
Suttantaṃ	सुत्तन्तं
Suttante	सुत्तन्ते
Suttasabhāgañcetaṃ	सुत्तसभागञ्चेतं
Sutte	सुत्ते
Suttāṇā	सुत्ताणा
Suvuttā	सुवुत्ता
Suṭṭhu	सुट्ठु
Svātanāya	स्वातनाय
Svāyaṃ	स्वायं
Sā	सा
Sādhu	साधु
Sāgato	सागतो
Sāmī	सामी
Sāpi	सापि
Sāriputta	सारिपुत्त
Sāriputtattheropi	सारिपुत्तत्थेरोपि
Sāvatthivāsīnaṃ	सावत्थिवासीनं
Sāyaṃ	सायं
Sāṭakaṃ	साटकं
Sīho	सीहो
Sīlapāramitaṃ	सीलपारमितं
Sīlapāramiñca	सीलपारमिञ्च
Sītaṃ	सीतं
Sūdati	सूदति
Sūlehipi	सूलेहिपि
Sūriyova	सूरियोव
Tadanantaraṃ	तदनन्तरं
Tadaññaṃ	तदञ्ञं
Tadā	तदा
Tampajjubbhijjate	तम्पज्जुब्भिज्जते
Tampi	तम्पि
Tasmiṃ	तस्मिं
Tasmā	तस्मा
Tassa	तस्स
Tassāpi	तस्सापि
Tatheva	तथेव
Tathevimaṃ	तथेविमं
Tathā	तथा
Tatiye	ततिये
Tato	ततो
Tatra	तत्र
Tatridaṃ	तत्रिदं
Tatrime	तत्रिमे
Tatrāyaṃ	तत्रायं
Tattha	तत्थ
Tatthappadhānaṃ	तत्थप्पधानं
Tatuddhaṃ	ततुद्धं
Tayo	तयो
Tañhi	तञ्हि
Taṃ	तं
Te	ते
Tehi	तेहि
Telayante	तेलयन्ते
Temāsaṃ	तेमासं
Tena	तेन
Tenetametassa	तेनेतमेतस्स
Tenāha	तेनाह
Tenāyaṃ	तेनायं
Tepajja	तेपज्ज
Tepajjubho	तेपज्जुभो
Tepi	तेपि
Tepiṭakaṃ	तेपिटकं
Tesaṃ	तेसं
Tesu	तेसु
Thaddhavisamabhūmibhāgasmiñhi	थद्धविसमभूमिभागस्मिञ्हि
Thalajā	थलजा
Therassa	थेरस्स
Therassāpi	थेरस्सापि
Thero	थेरो
Tikatikañceva	तिकतिकञ्चेव
Tikañca	तिकञ्च
Tike	तिके
Tiriyabhāgehi	तिरियभागेहि
Tisahassimahāsahassilokadhātuyā	तिसहस्सिमहासहस्सिलोकधातुया
Tissassa	तिस्सस्स
Tisso	तिस्सो
Tivaggasaṅgahāni	तिवग्गसङ्गहानि
Tiṇalatādigahanacchanne	तिणलतादिगहनच्छन्ने
Tiṇapaṇṇamattikāsu	तिणपण्णमत्तिकासु
Tulābhūto	तुलाभूतो
Tusitapurato	तुसितपुरतो
Tuṭṭhahaṭṭho	तुट्ठहट्ठो
Tvaṃ	त्वं
Tāni	तानि
Tānipajja	तानिपज्ज
Tāpasapabbajjaṃ	तापसपब्बज्जं
Tārāgaṇā	तारागणा
Tāvadeva	तावदेव
Tāvatā	तावता
Tīsupi	तीसुपि
Ubbiggā	उब्बिग्गा
Ubhinnamantare	उभिन्नमन्तरे
Ubhinnampi	उभिन्नम्पि
Ubhopi	उभोपि
Udakaṃ	उदकं
Uddhaṃ	उद्धं
Ukkuṭṭhisaddā	उक्कुट्ठिसद्दा
Upagacchuṃ	उपगच्छुं
Uparibhāgena	उपरिभागेन
Upekkhati	उपेक्खति
Upekkhāpāramitaṃ	उपेक्खापारमितं
Upeti	उपेति
Uppajjante	उप्पज्जन्ते
Upāgamiṃ	उपागमिं
Ussīsake	उस्सीसके
Uttarimanussadhammapeyyālaṃ	उत्तरिमनुस्सधम्मपेय्यालं
Uttarā	उत्तरा
Vamate	वमते
Vasamānāpi	वसमानापि
Vasībhūto	वसीभूतो
Vedajātaṃ	वेदजातं
Vedayanti	वेदयन्ति
Vemātikabhātā	वेमातिकभाता
Vibhaṅgappakaraṇaṃ	विभङ्गप्पकरणं
Vicinanto	विचिनन्तो
Vicittapupphā	विचित्तपुप्फा
Vidhūpayaṃ	विधूपयं
Vimalo	विमलो
Vinayadharabhikkhūnañhi	विनयधरभिक्खूनञ्हि
Vinayamattameva	विनयमत्तमेव
Vinayamattassapi	विनयमत्तस्सपि
Vinayapiṭake	विनयपिटके
Vinayatthavidūhi	विनयत्थविदूहि
Vinayañca	विनयञ्च
Vinaye	विनये
Visayato	विसयतो
Visaṅkhāragataṃ	विसङ्खारगतं
Visesena	विसेसेन
Vissatthā	विस्सत्था
Visuddhimagge	विसुद्धिमग्गे
Visuddhācārasīlena	विसुद्धाचारसीलेन
Visākhā	विसाखा
Vitathaṃ	वितथं
Vitaṇḍavādī	वितण्डवादी
Vitthārikaṃ	वित्थारिकं
Vitthāriyamānaṃ	वित्थारियमानं
Vitthāro	वित्थारो
Vividhavisesanayattā	विविधविसेसनयत्ता
Vividhā	विविधा
Vuttañhetaṃ	वुत्तञ्हेतं
Vuttādhikā	वुत्ताधिका
Vākacīraṃ	वाकचीरं
Vāpitaṃ	वापितं
Vātaṃ	वातं
Vīriyapāramitaṃ	वीरियपारमितं
Yadi	यदि
Yadimassa	यदिमस्स
Yadā	यदा
Yakkho	यक्खो
Yamahaṃ	यमहं
Yamakapāṭihāriyaṃ	यमकपाटिहारियं
Yamakasālānamantare	यमकसालानमन्तरे
Yamhi	यम्हि
Yasmā	यस्मा
Yassa	यस्स
Yathā	यथा
Yathānupubbaṃ	यथानुपुब्बं
Yathāpi	यथापि
Yathāvutteneva	यथावुत्तेनेव
Yato	यतो
Yatohaṃ	यतोहं
Yañca	यञ्च
Yaṃ	यं
Yaṃnūnimaṃ	यंनूनिमं
Ye	ये
Yo	यो
Yā	या
Yāvatā	यावता
a	अ
abbhokāsāvāso	अब्भोकासावासो
abbhuggantvā	अब्भुग्गन्त्वा
abbhutadhamma	अब्भुतधम्म
abbhutadhammaṃ	अब्भुतधम्मं
abbhutā	अब्भुता
abbhācikkhati	अब्भाचिक्खति
abhayo	अभयो
abhibhū	अभिभू
abhidhammadesanāpariyosānañca	अभिधम्मदेसनापरियोसानञ्च
abhidhammakathaṃ	अभिधम्मकथं
abhidhammanayasamuddaṃ	अभिधम्मनयसमुद्दं
abhidhammapiṭakanti	अभिधम्मपिटकन्ति
abhidhammapiṭakaṃ	अभिधम्मपिटकं
abhidhammapiṭake	अभिधम्मपिटके
abhidhammassa	अभिधम्मस्स
abhidhammatantiṃ	अभिधम्मतन्तिं
abhidhammato	अभिधम्मतो
abhidhammañca	अभिधम्मञ्च
abhidhammaṃ	अभिधम्मं
abhidhamme	अभिधम्मे
abhidhammo	अभिधम्मो
abhidhammoti	अभिधम्मोति
abhijāti	अभिजाति
abhikkama	अभिक्कम
abhikkamanti	अभिक्कमन्ति
abhikkantavaṇṇātiādīsu	अभिक्कन्तवण्णातिआदीसु
abhilakkhitātiādīsu	अभिलक्खितातिआदीसु
abhimukho	अभिमुखो
abhinanditabbaṃ	अभिनन्दितब्बं
abhinīhāro	अभिनीहारो
abhiravanti	अभिरवन्ति
abhirūpo	अभिरूपो
abhisaddo	अभिसद्दो
abhisamayo	अभिसमयो
abhisamayā	अभिसमया
abhisambodhi	अभिसम्बोधि
abhisaṅkhataṃ	अभिसङ्खतं
abhisaṅkhatā	अभिसङ्खता
abhissanno	अभिस्सन्नो
abhitthutaguṇo	अभित्थुतगुणो
abhivaditabbaṃ	अभिवदितब्बं
abhivandisuṃ	अभिवन्दिसुं
abhivassanti	अभिवस्सन्ति
abhivinayetiādīsu	अभिविनयेतिआदीसु
abhivādetvāna	अभिवादेत्वान
abhiyācito	अभियाचितो
abhiññatthāya	अभिञ्ञत्थाय
abhiññā	अभिञ्ञा
abhiññābala	अभिञ्ञाबल
abhiññābalamāhariṃ	अभिञ्ञाबलमाहरिं
abhiññābalasampanno	अभिञ्ञाबलसम्पन्नो
abhiññānañca	अभिञ्ञानञ्च
abhiññāpāramiṃ	अभिञ्ञापारमिं
abhiññāsu	अभिञ्ञासु
abhiññātā	अभिञ्ञाता
abhiññāya	अभिञ्ञाय
abhiññāyo	अभिञ्ञायो
abhiṇhaso	अभिण्हसो
abyākataṃ	अब्याकतं
abyākato	अब्याकतो
abyākatā	अब्याकता
abyākatāti	अब्याकताति
acalo	अचलो
acchariyaabbhutadhammappaṭisaṃyuttā	अच्छरियअब्भुतधम्मप्पटिसंयुत्ता
acchariyā	अच्छरिया
acchariyāni	अच्छरियानि
acetanabhāvena	अचेतनभावेन
acinteyyāni	अचिन्तेय्यानि
acinteyyānipi	अचिन्तेय्यानिपि
ada	अद
adaṃsu	अदंसु
addasa	अद्दस
addhā	अद्धा
addhāne	अद्धाने
adhicittasikkhā	अधिचित्तसिक्खा
adhigamanidānadesanānidānasampannassa	अधिगमनिदानदेसनानिदानसम्पन्नस्स
adhigamanidānañca	अधिगमनिदानञ्च
adhigamanidānaṃ	अधिगमनिदानं
adhigantvāva	अधिगन्त्वाव
adhigatavisesena	अधिगतविसेसेन
adhigataṃ	अधिगतं
adhigato	अधिगतो
adhigatābhidhammo	अधिगताभिधम्मो
adhigañchi	अधिगञ्छि
adhigaṇhitvā	अधिगण्हित्वा
adhike	अधिके
adhikāpi	अधिकापि
adhikārena	अधिकारेन
adhikāro	अधिकारो
adhimattadhitimā	अधिमत्तधितिमा
adhimattagatimā	अधिमत्तगतिमा
adhimattasatimā	अधिमत्तसतिमा
adhipati	अधिपति
adhipatipaccayo	अधिपतिपच्चयो
adhipaññāsikkhā	अधिपञ्ञासिक्खा
adhippeto	अधिप्पेतो
adhippāyaṃ	अधिप्पायं
adhippāyena	अधिप्पायेन
adhippāyo	अधिप्पायो
adhisīlasikkhā	अधिसीलसिक्खा
adhivāsentassa	अधिवासेन्तस्स
adhivāsesi	अधिवासेसि
adhiṭṭhahantassa	अधिट्ठहन्तस्स
adhiṭṭhānapāramitā	अधिट्ठानपारमिता
adhiṭṭhānapāramiṃ	अधिट्ठानपारमिं
adhiṭṭhāne	अधिट्ठाने
adhiṭṭhāniddhi	अधिट्ठानिद्धि
adhiṭṭhāya	अधिट्ठाय
adho	अधो
adhokato	अधोकतो
adhomukhaṭhapitaudakaghaṭā	अधोमुखठपितउदकघटा
advejjhamānaso	अद्वेज्झमानसो
advejjhavacano	अद्वेज्झवचनो
adāsi	अदासि
agamāsi	अगमासि
aggahesuṃ	अग्गहेसुं
aggahetvā	अग्गहेत्वा
aggahetvāna	अग्गहेत्वान
aggaphalasukhanti	अग्गफलसुखन्ति
aggaphale	अग्गफले
aggasāvakassa	अग्गसावकस्स
aggasāvakā	अग्गसावका
aggasāvikā	अग्गसाविका
aggaḷadānaṃ	अग्गळदानं
aggidatto	अग्गिदत्तो
aggijālaṃ	अग्गिजालं
aggikkhandhova	अग्गिक्खन्धोव
aggisālāyaṃ	अग्गिसालायं
aggā	अग्गा
aggī	अग्गी
agāmake	अगामके
ahampi	अहम्पि
ahañhi	अहञ्हि
ahaṃ	अहं
ahesuṃ	अहेसुं
ahitāya	अहिताय
ahosi	अहोसि
ahosīti	अहोसीति
ahu	अहु
ajapālamucalindarājāyatanesu	अजपालमुचलिन्दराजायतनेसु
ajapālanigrodharukkhamūle	अजपालनिग्रोधरुक्खमूले
ajaṭākāsaṃ	अजटाकासं
ajinacammaṃ	अजिनचम्मं
ajito	अजितो
ajja	अज्ज
ajjapetaṃ	अज्जपेतं
ajjhesanaṃ	अज्झेसनं
ajjhogāhetvā	अज्झोगाहेत्वा
ajjhositabbaṃ	अज्झोसितब्बं
ajjhotthaṭaṃ	अज्झोत्थटं
ajjhācārapaṭipakkhabhūto	अज्झाचारपटिपक्खभूतो
ajjhāsayaṃ	अज्झासयं
ajjunarukkho	अज्जुनरुक्खो
ajjāpi	अज्जापि
ajānanasippaṃ	अजाननसिप्पं
ajānanto	अजानन्तो
ajānitvāpi	अजानित्वापि
ajātipicchitabbakaṃ	अजातिपिच्छितब्बकं
akathetvā	अकथेत्वा
akatvā	अकत्वा
akilamatthaṃ	अकिलमत्थं
akittibrāhmaṇakāle	अकित्तिब्राह्मणकाले
akkamittha	अक्कमित्थ
akkamitvā	अक्कमित्वा
akkharāni	अक्खरानि
akkhitto	अक्खित्तो
akkhātanti	अक्खातन्ति
akkhātaṃ	अक्खातं
akkhāto	अक्खातो
akkhātoti	अक्खातोति
akkhīnañca	अक्खीनञ्च
akkhīni	अक्खीनि
akusalato	अकुसलतो
akusalavipākato	अकुसलविपाकतो
akusalaṃ	अकुसलं
akusalā	अकुसला
akāraṇaṃ	अकारणं
akāsi	अकासि
alabbhaneyyapatiṭṭhañca	अलब्भनेय्यपतिट्ठञ्च
alabbhaneyyapatiṭṭhā	अलब्भनेय्यपतिट्ठा
alabhiṃ	अलभिं
alagaddagavesī	अलगद्दगवेसी
alagaddapariyesanaṃ	अलगद्दपरियेसनं
alagaddassa	अलगद्दस्स
alagaddatthiko	अलगद्दत्थिको
alagaddaṃ	अलगद्दं
alagaddo	अलगद्दो
alagaddūpamā	अलगद्दूपमा
alaṅkatacaṅkamassa	अलङ्कतचङ्कमस्स
alaṅkatapaṭiyatto	अलङ्कतपटियत्तो
alīnasattukumārakāleti	अलीनसत्तुकुमारकालेति
amaccagaṇaparivuto	अमच्चगणपरिवुतो
amacco	अमच्चो
amakkhetvāva	अमक्खेत्वाव
amaravatiyā	अमरवतिया
amaravatī	अमरवती
amatantaḷe	अमतन्तळे
amatappakāsano	अमतप्पकासनो
amatapānaṃ	अमतपानं
amatassa	अमतस्स
amataṃ	अमतं
ambare	अम्बरे
amhe	अम्हे
amhākaṃ	अम्हाकं
amitabhogaṃ	अमितभोगं
amitā	अमिता
amoghavacanā	अमोघवचना
anamataggova	अनमतग्गोव
anantamaparimāṇaṃ	अनन्तमपरिमाणं
anantarapaccayo	अनन्तरपच्चयो
anantayasaṃ	अनन्तयसं
anantaṃ	अनन्तं
ananto	अनन्तो
anantā	अनन्ता
ananucchavikena	अननुच्छविकेन
anapaloketvā	अनपलोकेत्वा
anapekkhabhāvo	अनपेक्खभावो
anapekkho	अनपेक्खो
anapekkhā	अनपेक्खा
anativattentassa	अनतिवत्तेन्तस्स
anatthaṅgamiteyeva	अनत्थङ्गमितेयेव
anatthiko	अनत्थिको
anatthikā	अनत्थिका
anavajjapiṇḍapariyesanabhāvo	अनवज्जपिण्डपरियेसनभावो
anavajjasaññī	अनवज्जसञ्ञी
anaññātaññassāmītindriyaṃ	अनञ्ञातञ्ञस्सामीतिन्द्रियं
andhakāravelāyaṃ	अन्धकारवेलायं
andhakāraṃ	अन्धकारं
andugharaṃ	अन्दुघरं
andughare	अन्दुघरे
anekajjhāsayānusayacariyādhimuttikā	अनेकज्झासयानुसयचरियाधिमुत्तिका
anekakoṭisatasahassānaṃ	अनेककोटिसतसहस्सानं
anekappakāraṃ	अनेकप्पकारं
anekehi	अनेकेहि
anekesu	अनेकेसु
anekānusandhikaṃ	अनेकानुसन्धिकं
anibbisaṃ	अनिब्बिसं
aniccato	अनिच्चतो
animisasattāhaṃ	अनिमिससत्ताहं
animisehi	अनिमिसेहि
annapānasamāyutaṃ	अन्नपानसमायुतं
annapānena	अन्नपानेन
anojapupphadāmasadisaṃ	अनोजपुप्फदामसदिसं
anomadassī	अनोमदस्सी
anomaṃ	अनोमं
anomo	अनोमो
anomā	अनोमा
anomānadītīre	अनोमानदीतीरे
anotattadahatīre	अनोतत्तदहतीरे
anotattadahaṃ	अनोतत्तदहं
anotattadahe	अनोतत्तदहे
antalikkhe	अन्तलिक्खे
antamaso	अन्तमसो
antarantena	अन्तरन्तेन
antare	अन्तरे
antarāmagge	अन्तरामग्गे
antarāpatti	अन्तरापत्ति
antarāye	अन्तराये
antarāyikā	अन्तरायिका
antarāyāyāti	अन्तरायायाति
antesu	अन्तेसु
anto	अन्तो
antopaṇṇasālāyaṃ	अन्तोपण्णसालायं
antorukkhatā	अन्तोरुक्खता
anubhavamāno	अनुभवमानो
anubhavanto	अनुभवन्तो
anucchavikaṃ	अनुच्छविकं
anucchavikesu	अनुच्छविकेसु
anuciṇṇaṃ	अनुचिण्णं
anukkamena	अनुक्कमेन
anulomamhi	अनुलोमम्हि
anulomapaccanīyamhi	अनुलोमपच्चनीयम्हि
anulomapaccanīye	अनुलोमपच्चनीये
anulomapaccanīyepi	अनुलोमपच्चनीयेपि
anulomapaṭilomasaṅkhepavitthārādivasena	अनुलोमपटिलोमसङ्खेपवित्थारादिवसेन
anulomapaṭṭhāne	अनुलोमपट्ठाने
anulome	अनुलोमे
anulomiko	अनुलोमिको
anumodanaṃ	अनुमोदनं
anumodentānaṃ	अनुमोदेन्तानं
anumoditakālato	अनुमोदितकालतो
anupacitakusalasambhārehi	अनुपचितकुसलसम्भारेहि
anupadaṃ	अनुपदं
anupagantvā	अनुपगन्त्वा
anupakuṭṭho	अनुपकुट्ठो
anupaparikkhataṃ	अनुपपरिक्खतं
anupaññattinayā	अनुपञ्ञत्तिनया
anuppāde	अनुप्पादे
anupubbikathaṃ	अनुपुब्बिकथं
anupubbikathā	अनुपुब्बिकथा
anupādāya	अनुपादाय
anupāpuṇi	अनुपापुणि
anurakkhanto	अनुरक्खन्तो
anuruddho	अनुरुद्धो
anusandhivasena	अनुसन्धिवसेन
anusayapaṭipakkhattā	अनुसयपटिपक्खत्ता
anusayappahānaṃ	अनुसयप्पहानं
anusayayamakaṃ	अनुसययमकं
anusaṅgītā	अनुसङ्गीता
anussaritvā	अनुस्सरित्वा
anuttaro	अनुत्तरो
anuttarā	अनुत्तरा
anuyanti	अनुयन्ति
anuññātasukhasamphassaattharaṇapāvuraṇādiphassasāmaññato	अनुञ्ञातसुखसम्फस्सअत्थरणपावुरणादिफस्ससामञ्ञतो
anuḷā	अनुळा
anāgate	अनागते
anākulaṃ	अनाकुलं
anāpatti	अनापत्ति
apa	अप
apacitidassanatthaṃ	अपचितिदस्सनत्थं
apagatavāḷamigabhiṃsanakasakuṇaṃ	अपगतवाळमिगभिंसनकसकुणं
apakkamitvā	अपक्कमित्वा
aparabhāge	अपरभागे
aparaṃ	अपरं
aparihīnajjhāno	अपरिहीनज्झानो
aparimāṇo	अपरिमाणो
aparimāṇoyeva	अपरिमाणोयेव
aparimāṇā	अपरिमाणा
aparimāṇāva	अपरिमाणाव
aparituṭṭho	अपरितुट्ठो
aparānipi	अपरानिपि
aparāparaṃ	अपरापरं
apassanto	अपस्सन्तो
appagghaṃ	अप्पग्घं
appamattikāva	अप्पमत्तिकाव
appamaññāvibhaṅgo	अप्पमञ्ञाविभङ्गो
appamaññāyo	अप्पमञ्ञायो
appameyyo	अप्पमेय्यो
appamādena	अप्पमादेन
appamāṇā	अप्पमाणा
appasamārambhatā	अप्पसमारम्भता
appaṭicchādanabhāvo	अप्पटिच्छादनभावो
appaṭihatabhāvoti	अप्पटिहतभावोति
appesakkhā	अप्पेसक्खा
apphoṭenti	अप्फोटेन्ति
appicchabhāvo	अप्पिच्छभावो
appossukkataṃ	अप्पोस्सुक्कतं
apubbaṃ	अपुब्बं
apuññaṃ	अपुञ्ञं
arahantehi	अरहन्तेहि
arahanto	अरहन्तो
arahato	अरहतो
arahattaṃ	अरहत्तं
arahatte	अरहत्ते
arakapaṇḍitakāle	अरकपण्डितकाले
arati	अरति
araññaṃ	अरञ्ञं
araññe	अरञ्ञे
araṇā	अरणा
arindamo	अरिन्दमो
ariyamagge	अरियमग्गे
ariyapariyesana	अरियपरियेसन
ariyo	अरियो
aruṇavatī	अरुणवती
aruṇavā	अरुणवा
aruṇuggamanā	अरुणुग्गमना
arīhi	अरीहि
arūpino	अरूपिनो
arūpāvacarakusalato	अरूपावचरकुसलतो
asakkhikaṃ	असक्खिकं
asallakkhentā	असल्लक्खेन्ता
asamassa	असमस्स
asame	असमे
asammaṭṭhampi	असम्मट्ठम्पि
asammissaṃ	असम्मिस्सं
asammohato	असम्मोहतो
asamo	असमो
asampuṇṇabhāṇavāramattāya	असम्पुण्णभाणवारमत्ताय
asamā	असमा
asanarukkho	असनरुक्खो
asanthambhanabhāvo	असन्थम्भनभावो
asaññaṃ	असञ्ञं
asaṃsaṭṭhabhāvo	असंसट्ठभावो
asaṅgahitanti	असङ्गहितन्ति
asaṅgahitaṃ	असङ्गहितं
asaṅgahitena	असङ्गहितेन
asaṅgaho	असङ्गहो
asaṅkhiye	असङ्खिये
asaṅkhiyā	असङ्खिया
asaṅkhyeyyaṃ	असङ्ख्येय्यं
asaṅkhyeyyo	असङ्ख्येय्यो
asaṅkhyeyyānaṃ	असङ्ख्येय्यानं
asaṅkhyeyyāni	असङ्ख्येय्यानि
asekkhā	असेक्खा
asesato	असेसतो
asoko	असोको
asokā	असोका
assamapadaṃ	अस्समपदं
assamapaṇṇasālācaṅkamā	अस्समपण्णसालाचङ्कमा
assamaṃ	अस्समं
assame	अस्समे
assamo	अस्समो
assaratanaṃ	अस्सरतनं
assasaddaṃ	अस्ससद्दं
assatthoti	अस्सत्थोति
assāti	अस्साति
asucimpi	असुचिम्पि
asuciṃ	असुचिं
asukassa	असुकस्स
asāruppabhāvo	असारुप्पभावो
asītibhikkhusahassāni	असीतिभिक्खुसहस्सानि
asītihatthamatte	असीतिहत्थमत्ते
asītihatthappamāṇāyeva	असीतिहत्थप्पमाणायेव
asītihatthubbedhaṃ	असीतिहत्थुब्बेधं
asītikoṭidhanaṃ	असीतिकोटिधनं
asītikoṭisahassāni	असीतिकोटिसहस्सानि
asītikoṭiyo	असीतिकोटियो
asītisahassāni	असीतिसहस्सानि
asītivassasahassāni	असीतिवस्ससहस्सानि
atha	अथ
athassa	अथस्स
atibrahmāti	अतिब्रह्माति
aticchattanti	अतिच्छत्तन्ति
atidevo	अतिदेवो
atidevoti	अतिदेवोति
atidhajoti	अतिधजोति
atidhāvanto	अतिधावन्तो
atikkamitvā	अतिक्कमित्वा
atikkamma	अतिक्कम्म
atikkante	अतिक्कन्ते
atirekabhāṇavāramatto	अतिरेकभाणवारमत्तो
atirekabhāṇavāro	अतिरेकभाणवारो
atirekachabhāṇavāramattaṃ	अतिरेकछभाणवारमत्तं
atirekachabhāṇavāraṃ	अतिरेकछभाणवारं
atirekadvibhāṇavāramatto	अतिरेकद्विभाणवारमत्तो
atirekadvibhāṇavāraṃ	अतिरेकद्विभाणवारं
atirekapañcabhāṇavārā	अतिरेकपञ्चभाणवारा
atirekappamāṇaṃ	अतिरेकप्पमाणं
atirekappamāṇo	अतिरेकप्पमाणो
atirekataro	अतिरेकतरो
atirekatarā	अतिरेकतरा
atirekaterasamattabhāṇavāraṃ	अतिरेकतेरसमत्तभाणवारं
atirocati	अतिरोचति
atirājakumāroti	अतिराजकुमारोति
atisambādhatā	अतिसम्बाधता
ativisālatā	अतिविसालता
ativisālatāti	अतिविसालताति
ativiya	अतिविय
attabhāve	अत्तभावे
attano	अत्तनो
attanā	अत्तना
attapariccāgaṃ	अत्तपरिच्चागं
attatthaparatthādibhede	अत्तत्थपरत्थादिभेदे
atthadassī	अत्थदस्सी
atthajotanā	अत्थजोतना
atthajātaṃ	अत्थजातं
atthapaṭisambhidāti	अत्थपटिसम्भिदाति
atthassa	अत्थस्स
atthato	अत्थतो
atthaṃ	अत्थं
atthe	अत्थे
atthesu	अत्थेसु
atthi	अत्थि
atthibhāvampi	अत्थिभावम्पि
atthibhāvo	अत्थिभावो
atthipaccayo	अत्थिपच्चयो
attho	अत्थो
atthoti	अत्थोति
atthuddhārabhūtaṃ	अत्थुद्धारभूतं
atthuddhāroti	अत्थुद्धारोति
atthā	अत्था
atthānurūpaṃ	अत्थानुरूपं
atthīti	अत्थीति
attānañca	अत्तानञ्च
attānaṃ	अत्तानं
atulo	अतुलो
avabodho	अवबोधो
avakujjo	अवकुज्जो
avasesaṃ	अवसेसं
avasesā	अवसेसा
avatvā	अवत्वा
avedi	अवेदि
avelāya	अवेलाय
avidūrenidānakathā	अविदूरेनिदानकथा
avidūrenidānaṃ	अविदूरेनिदानं
avigatapaccayoti	अविगतपच्चयोति
avijjā	अविज्जा
avijjābhāgino	अविज्जाभागिनो
avijjāya	अविज्जाय
aviparītasabhāvo	अविपरीतसभावो
aviparītāvabodhasaṅkhāto	अविपरीतावबोधसङ्खातो
avisayo	अविसयो
avisiṭṭhaṃ	अविसिट्ठं
avivittaṃ	अविवित्तं
aviññāya	अविञ्ञाय
ayamassa	अयमस्स
ayampi	अयम्पि
ayamānubhāvo	अयमानुभावो
ayañca	अयञ्च
ayañhi	अयञ्हि
ayaṃ	अयं
ayogharapaṇḍitakāleti	अयोघरपण्डितकालेति
ayya	अय्य
ayyakapayyakānaṃ	अय्यकपय्यकानं
ayyāti	अय्याति
añjaliṃ	अञ्जलिं
añjanacuṇṇasamokiṇṇaṃ	अञ्जनचुण्णसमोकिण्णं
añjanādibhesajjāni	अञ्जनादिभेसज्जानि
añjasassa	अञ्जसस्स
añjasaṃ	अञ्जसं
añjitaakkhīni	अञ्जितअक्खीनि
aññamaññapaccayo	अञ्ञमञ्ञपच्चयो
aññamaññasaṅkaravirahite	अञ्ञमञ्ञसङ्करविरहिते
aññamaññassa	अञ्ञमञ्ञस्स
aññamaññaṃ	अञ्ञमञ्ञं
aññampi	अञ्ञम्पि
aññatarasmiṃ	अञ्ञतरस्मिं
aññathattaṃ	अञ्ञथत्तं
aññathā	अञ्ञथा
aññatra	अञ्ञत्र
aññaṃ	अञ्ञं
aññe	अञ्ञे
aññena	अञ्ञेन
aññesaṃ	अञ्ञेसं
añño	अञ्ञो
aññāsikoṇḍaññattherappamukhā	अञ्ञासिकोण्डञ्ञत्थेरप्पमुखा
aññātavesena	अञ्ञातवेसेन
aḍḍaṃ	अड्डं
aḍḍhachakkesu	अड्ढछक्केसु
aḍḍharatanike	अड्ढरतनिके
aṃse	अंसे
aṅgapaccaṅge	अङ्गपच्चङ्गे
aṅgato	अङ्गतो
aṅgavasena	अङ्गवसेन
aṅgehi	अङ्गेहि
aṅguliyopi	अङ्गुलियोपि
aṅguttaranikāyo	अङ्गुत्तरनिकायो
aṅguttare	अङ्गुत्तरे
aṅgārakapalladāruādīnīti	अङ्गारकपल्लदारुआदीनीति
aṅkusakapacchitidaṇḍakādīni	अङ्कुसकपच्छितिदण्डकादीनि
aṭṭha	अट्ठ
aṭṭhadosasamākiṇṇaṃ	अट्ठदोससमाकिण्णं
aṭṭhaguṇasamupetaṃ	अट्ठगुणसमुपेतं
aṭṭhahi	अट्ठहि
aṭṭhakathākaṇḍaṃ	अट्ठकथाकण्डं
aṭṭhakathāya	अट्ठकथाय
aṭṭhamaṃ	अट्ठमं
aṭṭhame	अट्ठमे
aṭṭhamo	अट्ठमो
aṭṭhamoti	अट्ठमोति
aṭṭhamukhā	अट्ठमुखा
aṭṭhanahutādhikacatuyojanasatasahassabahalaṃ	अट्ठनहुताधिकचतुयोजनसतसहस्सबहलं
aṭṭhanavutibhikkhusatasahassāni	अट्ठनवुतिभिक्खुसतसहस्सानि
aṭṭhapaṇṇāsahatthubbedhaṃ	अट्ठपण्णासहत्थुब्बेधं
aṭṭhasaṭṭhibhikkhusatasahassāni	अट्ठसट्ठिभिक्खुसतसहस्सानि
aṭṭhasu	अट्ठसु
aṭṭhatiṇamuṭṭhiṃ	अट्ठतिणमुट्ठिं
aṭṭhaṅgiko	अट्ठङ्गिको
aṭṭhānaṃ	अट्ठानं
aṭṭhārasa	अट्ठारस
aṭṭhārasakappasataccayena	अट्ठारसकप्पसतच्चयेन
aṭṭhārasakappasatamatthake	अट्ठारसकप्पसतमत्थके
aṭṭhārasasu	अट्ठारससु
aṭṭhārasavassādhikānaṃ	अट्ठारसवस्साधिकानं
aṭṭhārasavassādhikāni	अट्ठारसवस्साधिकानि
aṭṭhārasavidhena	अट्ठारसविधेन
aṭṭhāsi	अट्ठासि
aṭṭhāsītihatthubbedhaṃ	अट्ठासीतिहत्थुब्बेधं
aṭṭhāsītisahassāni	अट्ठासीतिसहस्सानि
baddhaṃ	बद्धं
bahussuto	बहुस्सुतो
bahusādhāraṇabhāvo	बहुसाधारणभावो
bahusādhāraṇagehe	बहुसाधारणगेहे
bahuñca	बहुञ्च
bahuṃ	बहुं
bahū	बहू
bahūpakārataṃ	बहूपकारतं
bahūsu	बहूसु
balabojjhaṅgakammavipākantaraṃ	बलबोज्झङ्गकम्मविपाकन्तरं
balavabhāvaṃ	बलवभावं
balavanti	बलवन्ति
balavapaccūse	बलवपच्चूसे
balavapīti	बलवपीति
balavataraṃ	बलवतरं
balavā	बलवा
balaṃ	बलं
bandhanaṃ	बन्धनं
bandhati	बन्धति
bandhumatī	बन्धुमती
bandhumā	बन्धुमा
beluvapakkavaṇṇā	बेलुवपक्कवण्णा
bhaddaji	भद्दजि
bhaddanāmo	भद्दनामो
bhaddasālo	भद्दसालो
bhaddo	भद्दो
bhaddā	भद्दा
bhadrayobbanaṃ	भद्रयोब्बनं
bhagavantaṃyeva	भगवन्तंयेव
bhagavato	भगवतो
bhagavatā	भगवता
bhagavatātiādinayappavattā	भगवतातिआदिनयप्पवत्ता
bhagavā	भगवा
bhaggā	भग्गा
bhante	भन्ते
bhanteti	भन्तेति
bhantā	भन्ता
bhatiyā	भतिया
bhatiṃ	भतिं
bhattakiccaṃ	भत्तकिच्चं
bhattānumodanakālepi	भत्तानुमोदनकालेपि
bhava	भव
bhavanaṃ	भवनं
bhavanti	भवन्ति
bhavantvantarāyā	भवन्त्वन्तराया
bhavati	भवति
bhavato	भवतो
bhavaṃ	भवं
bhavaṅgaparivāso	भवङ्गपरिवासो
bhave	भवे
bhaveyyanti	भवेय्यन्ति
bhaveyyāti	भवेय्याति
bhavissantīti	भविस्सन्तीति
bhavissare	भविस्सरे
bhavissasi	भविस्ससि
bhavissasīti	भविस्ससीति
bhavissati	भविस्सति
bhavissatīti	भविस्सतीति
bhavissāmi	भविस्सामि
bhavābhave	भवाभवे
bhavāmahaṃ	भवामहं
bhaṇati	भणति
bhaṇḍamādiya	भण्डमादिय
bhaṇḍāgārikapariyattī	भण्डागारिकपरियत्ती
bhaṇḍāgārikapariyattīti	भण्डागारिकपरियत्तीति
bhedakaravatthūsu	भेदकरवत्थूसु
bhedanaṃ	भेदनं
bherisaṅkharathāni	भेरिसङ्खरथानि
bheriyo	भेरियो
bheriṃ	भेरिं
bhesajjatthāya	भेसज्जत्थाय
bhijjantīti	भिज्जन्तीति
bhikkhanto	भिक्खन्तो
bhikkhave	भिक्खवे
bhikkhavoti	भिक्खवोति
bhikkhaṃ	भिक्खं
bhikkhu	भिक्खु
bhikkhunā	भिक्खुना
bhikkhusahassamajjhe	भिक्खुसहस्समज्झे
bhikkhusatasahassaṃ	भिक्खुसतसहस्सं
bhikkhusatasahassāni	भिक्खुसतसहस्सानि
bhikkhusatānaṃ	भिक्खुसतानं
bhikkhusaṅghassa	भिक्खुसङ्घस्स
bhikkhusaṅghaṃ	भिक्खुसङ्घं
bhikkhusaṅghepi	भिक्खुसङ्घेपि
bhikkhusaṅgho	भिक्खुसङ्घो
bhikkhuto	भिक्खुतो
bhikkhācāravelaṃ	भिक्खाचारवेलं
bhikkhāya	भिक्खाय
bhikkhū	भिक्खू
bhikkhūhi	भिक्खूहि
bhikkhūnaṃ	भिक्खूनं
bhikkhūsu	भिक्खूसु
bhikkhūti	भिक्खूति
bhindissāmi	भिन्दिस्सामि
bhinditvā	भिन्दित्वा
bhittiyaṃ	भित्तियं
bhiyyo	भिय्यो
bhiyyoso	भिय्योसो
bho	भो
bhoge	भोगे
bhojanaṃ	भोजनं
bhojayitvāna	भोजयित्वान
bhusavātehi	भुसवातेहि
bhāgī	भागी
bhājanampi	भाजनम्पि
bhājanato	भाजनतो
bhājessatīti	भाजेस्सतीति
bhāradvājo	भारद्वाजो
bhāramoropanaṃ	भारमोरोपनं
bhāsamānassa	भासमानस्स
bhāsaṃ	भासं
bhāsitaṃ	भासितं
bhāsitoti	भासितोति
bhāsāya	भासाय
bhātha	भाथ
bhāvanāmayiddhi	भावनामयिद्धि
bhāvaya	भावय
bhāveti	भावेति
bhāvitamaggo	भावितमग्गो
bhāvitatto	भावितत्तो
bhāyāmi	भायामि
bhītā	भीता
bhūmantaraparicchedo	भूमन्तरपरिच्छेदो
bhūmaṭṭhā	भूमट्ठा
bhūmi	भूमि
bhūmitalagatā	भूमितलगता
bhūmito	भूमितो
bhūmiyañceva	भूमियञ्चेव
bhūmiyaṃ	भूमियं
bhūmiyā	भूमिया
bhūmīsu	भूमीसु
bhūridattanāgarājakāle	भूरिदत्तनागराजकाले
bidalamañcakapasse	बिदलमञ्चकपस्से
bidalamañcako	बिदलमञ्चको
bimbijālotipi	बिम्बिजालोतिपि
bodheti	बोधेति
bodhi	बोधि
bodhiabhinīhārasaddhāya	बोधिअभिनीहारसद्धाय
bodhimaṇḍamhi	बोधिमण्डम्हि
bodhimaṇḍaṃ	बोधिमण्डं
bodhimaṇḍe	बोधिमण्डे
bodhimaṇḍā	बोधिमण्डा
bodhimuttamaṃ	बोधिमुत्तमं
bodhimūlamupehiti	बोधिमूलमुपेहिति
bodhimūle	बोधिमूले
bodhiparibbājakakāle	बोधिपरिब्बाजककाले
bodhipācanā	बोधिपाचना
bodhisattacariyakāle	बोधिसत्तचरियकाले
bodhisattakāle	बोधिसत्तकाले
bodhisattassa	बोधिसत्तस्स
bodhisattaṃ	बोधिसत्तं
bodhisatto	बोधिसत्तो
bodhisattānaṃ	बोधिसत्तानं
bodhiyā	बोधिया
bodhiṃ	बोधिं
bojjhaṅgavibhaṅgo	बोज्झङ्गविभङ्गो
bojjhaṅgā	बोज्झङ्गा
brahmabhūto	ब्रह्मभूतो
brahmadevo	ब्रह्मदेवो
brahmaghosaṃ	ब्रह्मघोसं
brahmajālādīni	ब्रह्मजालादीनि
brahmakoṭiyo	ब्रह्मकोटियो
brahmaloke	ब्रह्मलोके
brahmassaraṃ	ब्रह्मस्सरं
brahmuno	ब्रह्मुनो
brahmāpi	ब्रह्मापि
brāhmaṇamāṇavo	ब्राह्मणमाणवो
brāhmaṇasippameva	ब्राह्मणसिप्पमेव
brāhmaṇassa	ब्राह्मणस्स
brāhmaṇavaṇṇena	ब्राह्मणवण्णेन
brāhmaṇaṃ	ब्राह्मणं
brāhmaṇo	ब्राह्मणो
brāhmaṇī	ब्राह्मणी
bu	बु
buddhabhāsitameva	बुद्धभासितमेव
buddhabhāsitaṃ	बुद्धभासितं
buddhabhāsito	बुद्धभासितो
buddhabhāsitoti	बुद्धभासितोति
buddhabhāsitānīti	बुद्धभासितानीति
buddhabhāvatthāya	बुद्धभावत्थाय
buddhabhāvaṃ	बुद्धभावं
buddhabhūmiṃ	बुद्धभूमिं
buddhabhūtassa	बुद्धभूतस्स
buddhabījaṃ	बुद्धबीजं
buddhacakkhunā	बुद्धचक्खुना
buddhadhammā	बुद्धधम्मा
buddhaghosena	बुद्धघोसेन
buddhaguṇaṃ	बुद्धगुणं
buddhakare	बुद्धकरे
buddhakarā	बुद्धकरा
buddhameva	बुद्धमेव
buddhantaraṃ	बुद्धन्तरं
buddhapaccekabuddhādīhi	बुद्धपच्चेकबुद्धादीहि
buddhappamukhassa	बुद्धप्पमुखस्स
buddhappamukhaṃ	बुद्धप्पमुखं
buddharasmīhiyeva	बुद्धरस्मीहियेव
buddharatane	बुद्धरतने
buddhaseṭṭhānaṃ	बुद्धसेट्ठानं
buddhassa	बुद्धस्स
buddhasāsanaṃ	बुद्धसासनं
buddhato	बुद्धतो
buddhavacananti	बुद्धवचनन्ति
buddhavacanassa	बुद्धवचनस्स
buddhavacanaṃ	बुद्धवचनं
buddhavaṃse	बुद्धवंसे
buddhañāṇena	बुद्धञाणेन
buddhena	बुद्धेन
buddhijo	बुद्धिजो
buddho	बुद्धो
buddhoti	बुद्धोति
buddhā	बुद्धा
buddhālokeneva	बुद्धालोकेनेव
buddhānameva	बुद्धानमेव
buddhānaṃ	बुद्धानं
buddhārammaṇaṃ	बुद्धारम्मणं
budhaṃ	बुधं
bujjhante	बुज्झन्ते
bujjhare	बुज्झरे
bujjhassu	बुज्झस्सु
bujjhissati	बुज्झिस्सति
byapagataṃ	ब्यपगतं
byādhidhammo	ब्याधिधम्मो
byādhito	ब्याधितो
byādhiṃ	ब्याधिं
byākaramāno	ब्याकरमानो
byākaraṇaṃ	ब्याकरणं
byākareyya	ब्याकरेय्य
byākareyyaṃ	ब्याकरेय्यं
byākaritvā	ब्याकरित्वा
byākaroti	ब्याकरोति
byākatanti	ब्याकतन्ति
byākāsi	ब्याकासि
byākāsiṃ	ब्याकासिं
byāmappabhā	ब्यामप्पभा
byāthitamānasā	ब्याथितमानसा
bāhujaññaṃ	बाहुजञ्ञं
bāhā	बाहा
bāhāya	बाहाय
bārāṇasī	बाराणसी
bāvīsatindriyāni	बावीसतिन्द्रियानि
bāḷhā	बाळ्हा
bījāni	बीजानि
ca	च
cajitvā	चजित्वा
cakkaratanaṃ	चक्करतनं
cakkaratanāni	चक्करतनानि
cakkavattirañño	चक्कवत्तिरञ्ञो
cakkavattirājā	चक्कवत्तिराजा
cakkavattī	चक्कवत्ती
cakkavāḷapabbatena	चक्कवाळपब्बतेन
cakkaṃ	चक्कं
cakkhubhūto	चक्खुभूतो
cakkhuma	चक्खुम
cakkhūhi	चक्खूहि
camarī	चमरी
cammakaṃ	चम्मकं
campakarukkho	चम्पकरुक्खो
campakaṃ	चम्पकं
campeyyanāgarājakāle	चम्पेय्यनागराजकाले
campā	चम्पा
candakumārakāle	चन्दकुमारकाले
candamhi	चन्दम्हि
candamittā	चन्दमित्ता
candanacuṇṇañca	चन्दनचुण्णञ्च
candanavanaṃ	चन्दनवनं
candappabhā	चन्दप्पभा
candavatī	चन्दवती
candimasūriyādayo	चन्दिमसूरियादयो
candimāyuttā	चन्दिमायुत्ता
cando	चन्दो
candā	चन्दा
caramāno	चरमानो
carantassa	चरन्तस्स
caraṇo	चरणो
carituṃ	चरितुं
caritvā	चरित्वा
cariyā	चरिया
cariyābhiññā	चरियाभिञ्ञा
cariyāpiṭakato	चरियापिटकतो
carāpetvā	चरापेत्वा
cassa	चस्स
catasso	चतस्सो
catthāya	चत्थाय
cattālīsabhikkhusahassāni	चत्तालीसभिक्खुसहस्सानि
cattālīsahatthubbedhaṃ	चत्तालीसहत्थुब्बेधं
cattālīsavassasahassāni	चत्तालीसवस्ससहस्सानि
cattālīsaṃ	चत्तालीसं
cattāri	चत्तारि
cattārimāni	चत्तारिमानि
cattāro	चत्तारो
cattārome	चत्तारोमे
cattārīti	चत्तारीति
catubbidho	चतुब्बिधो
catubbidhopi	चतुब्बिधोपि
catumahādīparajjaṃ	चतुमहादीपरज्जं
catunavutikappamatthake	चतुनवुतिकप्पमत्थके
catunnaṃ	चतुन्नं
catuparisamajjhe	चतुपरिसमज्झे
caturo	चतुरो
caturoghaniddharaṇatthaṃ	चतुरोघनिद्धरणत्थं
caturopete	चतुरोपेते
caturāsīti	चतुरासीति
caturāsītidhammakkhandhasahassāni	चतुरासीतिधम्मक्खन्धसहस्सानि
caturāsītisahassappabhedaṃ	चतुरासीतिसहस्सप्पभेदं
caturāsītiyojanasahassagambhīre	चतुरासीतियोजनसहस्सगम्भीरे
caturāsītiyojanasahassagambhīro	चतुरासीतियोजनसहस्सगम्भीरो
caturāsītiyojanasahassamatthake	चतुरासीतियोजनसहस्समत्थके
catutthavāre	चतुत्थवारे
catutthaṃ	चतुत्थं
catutthe	चतुत्थे
catuttho	चतुत्थो
catuttiṃsa	चतुत्तिंस
catuvīsatippabhede	चतुवीसतिप्पभेदे
catuvīsatisamantapaṭṭhānasamodhānaṃ	चतुवीसतिसमन्तपट्ठानसमोधानं
catuvīsatisamantapaṭṭhānaṃ	चतुवीसतिसमन्तपट्ठानं
catuvīsatividhena	चतुवीसतिविधेन
catuvīsatiyā	चतुवीसतिया
catūsu	चतूसु
cavitvā	चवित्वा
cañjaliṃ	चञ्जलिं
caṅkamadosā	चङ्कमदोसा
caṅkamakoṭiṃ	चङ्कमकोटिं
caṅkamanakoṭiyaṃ	चङ्कमनकोटियं
caṅkamanasattāhañca	चङ्कमनसत्ताहञ्च
caṅkamanaṃ	चङ्कमनं
caṅkamantassa	चङ्कमन्तस्स
caṅkamanto	चङ्कमन्तो
caṅkamavemajjhe	चङ्कमवेमज्झे
caṅkamañca	चङ्कमञ्च
caṅkamaṃ	चङ्कमं
caṅkame	चङ्कमे
caṅkami	चङ्कमि
ce	चे
cepi	चेपि
cesa	चेस
cetaso	चेतसो
cetasā	चेतसा
cetaṃ	चेतं
cetesu	चेतेसु
cetiyagirimhi	चेतियगिरिम्हि
cetiyaṃ	चेतियं
cettha	चेत्थ
cetāni	चेतानि
ceva	चेव
cha	छ
chabbassāni	छब्बस्सानि
chabbaṇṇarasmiyo	छब्बण्णरस्मियो
chabbidhena	छब्बिधेन
chaddantanāgarājakāle	छद्दन्तनागराजकाले
chahi	छहि
chamattabhāṇavāro	छमत्तभाणवारो
chandatā	छन्दता
channasahāyova	छन्नसहायोव
channaṃ	छन्नं
chappakaraṇāni	छप्पकरणानि
chattaṃ	छत्तं
chattesu	छत्तेसु
chavaṭṭhikaṃ	छवट्ठिकं
chavivaṇṇo	छविवण्णो
chaḍḍayitvāna	छड्डयित्वान
chaḍḍayiṃ	छड्डयिं
chaḍḍetha	छड्डेथ
chaḍḍetvā	छड्डेत्वा
chaḷabhiññehi	छळभिञ्ञेहि
chaḷabhiññā	छळभिञ्ञा
chaṭṭhamaṃ	छट्ठमं
chaṭṭho	छट्ठो
chindissāmīti	छिन्दिस्सामीति
chinditvā	छिन्दित्वा
chuddhā	छुद्धा
cikkhallikanikāyoti	चिक्खल्लिकनिकायोति
cintayato	चिन्तयतो
cintayitvāna	चिन्तयित्वान
cintento	चिन्तेन्तो
cintesahaṃ	चिन्तेसहं
cintesi	चिन्तेसि
cintetabbāni	चिन्तेतब्बानि
cinteti	चिन्तेति
cintetvā	चिन्तेत्वा
cintitadhammaṃ	चिन्तितधम्मं
cintā	चिन्ता
ciravuttho	चिरवुत्थो
cirāyanti	चिरायन्ति
cito	चितो
citoti	चितोति
cittakkhepaṃ	चित्तक्खेपं
cittapariyādānādīni	चित्तपरियादानादीनि
cittassa	चित्तस्स
cittavibhatti	चित्तविभत्ति
cittavārabhājanaṃ	चित्तवारभाजनं
cittayamakaṃ	चित्तयमकं
cittaṃ	चित्तं
cittekaggatā	चित्तेकग्गता
cittena	चित्तेन
cittāni	चित्तानि
cittīkārapītibahulo	चित्तीकारपीतिबहुलो
ciṇṇavasī	चिण्णवसी
coravilope	चोरविलोपे
corehi	चोरेहि
cuddasavidhena	चुद्दसविधेन
cuto	चुतो
cutā	चुता
cutūpapātañāṇaṃ	चुतूपपातञाणं
cāgaṃ	चागं
cālā	चाला
cāpi	चापि
cāti	चाति
cātumahārājadattiyaṃ	चातुमहाराजदत्तियं
cātumahārājike	चातुमहाराजिके
cāvetukāmoti	चावेतुकामोति
cāyaṃ	चायं
cīnapiṭṭhacuṇṇarañjitā	चीनपिट्ठचुण्णरञ्जिता
cīvaraggahaṇaṃ	चीवरग्गहणं
cīvarapaccaye	चीवरपच्चये
cīvaravaṃse	चीवरवंसे
cīvaraṃ	चीवरं
cūḷasutasomajātakāle	चूळसुतसोमजातकाले
cūḷāya	चूळाय
dadamānasseva	ददमानस्सेव
dadamāno	ददमानो
dadamānā	ददमाना
dadantassa	ददन्तस्स
dadāmi	ददामि
dadātha	ददाथ
daharakāleyeva	दहरकालेयेव
dakajā	दकजा
dakkhiṇahatthaṃ	दक्खिणहत्थं
dakkhiṇaṃ	दक्खिणं
dakkhiṇena	दक्खिणेन
dantehi	दन्तेहि
dantāvaraṇaṃ	दन्तावरणं
darīsayā	दरीसया
dasa	दस
dasabalacatuvesārajjādisabbabuddhaguṇapaṭimaṇḍitaṃ	दसबलचतुवेसारज्जादिसब्बबुद्धगुणपटिमण्डितं
dasabalassa	दसबलस्स
dasabalena	दसबलेन
dasacakkavāḷasahassāni	दसचक्कवाळसहस्सानि
dasahi	दसहि
dasahupāgata	दसहुपागत
dasahupāgataṃ	दसहुपागतं
dasahāgamma	दसहागम्म
dasamaṃ	दसमं
dasamo	दसमो
dasamoti	दसमोति
dasapāramī	दसपारमी
dasasahassacakkavāḷadevatānaṃ	दससहस्सचक्कवाळदेवतानं
dasasahasse	दससहस्से
dasasahassilokadhātudevatāhi	दससहस्सिलोकधातुदेवताहि
dasasahassilokadhātuṃ	दससहस्सिलोकधातुं
dasasahassimahābrahmaparivārena	दससहस्सिमहाब्रह्मपरिवारेन
dasasahassiyaṃ	दससहस्सियं
dasasahassiṃ	दससहस्सिं
dasasahassādhivāsino	दससहस्साधिवासिनो
dasasahassī	दससहस्सी
dasasahassīnacūbhayaṃ	दससहस्सीनचूभयं
dasavaggapariggaho	दसवग्गपरिग्गहो
dasavidhe	दसविधे
dasavidhena	दसविधेन
dasindriyā	दसिन्द्रिया
dassaneyyaṃ	दस्सनेय्यं
dassanīyo	दस्सनीयो
dassentassa	दस्सेन्तस्स
dassentena	दस्सेन्तेन
dassenti	दस्सेन्ति
dassesi	दस्सेसि
dassetuṃ	दस्सेतुं
dassitasamuddasadisaṃ	दस्सितसमुद्दसदिसं
dassitaṃ	दस्सितं
dassitā	दस्सिता
dassāmīti	दस्सामीति
dasuttarasatasuttantā	दसुत्तरसतसुत्तन्ता
dasuttarasuttantehi	दसुत्तरसुत्तन्तेहि
dasāyatanā	दसायतना
datvā	दत्वा
datvāna	दत्वान
daḷhaṃ	दळ्हं
daḷho	दळ्हो
daḷhīkammasithilakaraṇappayojanā	दळ्हीकम्मसिथिलकरणप्पयोजना
daṇḍakadīpikāveṭhananiyāmena	दण्डकदीपिकावेठननियामेन
daṭṭhabbo	दट्ठब्बो
daṭṭho	दट्ठो
dehīti	देहीति
dente	देन्ते
denti	देन्ति
desanā	देसना
desanānidānañca	देसनानिदानञ्च
desanānidānaṃ	देसनानिदानं
desaṃ	देसं
desentassa	देसेन्तस्स
desento	देसेन्तो
desentova	देसेन्तोव
desentānaṃ	देसेन्तानं
desesi	देसेसि
desetabbadesanā	देसेतब्बदेसना
deseti	देसेति
desetuṃ	देसेतुं
desetvā	देसेत्वा
desetūti	देसेतूति
deseyyanti	देसेय्यन्ति
desitabhāvo	देसितभावो
desitadesanaṃ	देसितदेसनं
desitadhammo	देसितधम्मो
desitadhammopi	देसितधम्मोपि
desitattā	देसितत्ता
desitaṃ	देसितं
desito	देसितो
desitoti	देसितोति
desitā	देसिता
desitāti	देसिताति
dessaṃ	देस्सं
dessā	देस्सा
deti	देति
deva	देव
devabhavanamhi	देवभवनम्हि
devadevo	देवदेवो
devadūte	देवदूते
devalo	देवलो
devalokameva	देवलोकमेव
devalokasiriṃ	देवलोकसिरिं
devalokato	देवलोकतो
devalokaṃ	देवलोकं
devaloke	देवलोके
devamanussā	देवमनुस्सा
devanagaraṃva	देवनगरंव
devaputtena	देवपुत्तेन
devarañño	देवरञ्ञो
devaraññā	देवरञ्ञा
devarājā	देवराजा
devasikaṃ	देवसिकं
devatā	देवता
devatāhi	देवताहि
devatānaṃ	देवतानं
deve	देवे
devehi	देवेहि
devesu	देवेसु
devo	देवो
devorohanaṃ	देवोरोहनं
devā	देवा
devānamindo	देवानमिन्दो
devānaṃ	देवानं
devāpi	देवापि
devāsane	देवासने
dha	ध
dhajesu	धजेसु
dhajo	धजो
dhammabhūto	धम्मभूतो
dhammacakkappavattanaṃ	धम्मचक्कप्पवत्तनं
dhammacakkappavattanā	धम्मचक्कप्पवत्तना
dhammacakkaṃ	धम्मचक्कं
dhammacintaṃ	धम्मचिन्तं
dhammacāriṃ	धम्मचारिं
dhammacārīti	धम्मचारीति
dhammadassī	धम्मदस्सी
dhammadesanavelā	धम्मदेसनवेला
dhammadesanaṃ	धम्मदेसनं
dhammadesane	धम्मदेसने
dhammadesayi	धम्मदेसयि
dhammadhātuyañca	धम्मधातुयञ्च
dhammadhātuyā	धम्मधातुया
dhammadinnā	धम्मदिन्ना
dhammagambhīratāpaccavekkhaṇena	धम्मगम्भीरतापच्चवेक्खणेन
dhammahadayavibhaṅgoti	धम्महदयविभङ्गोति
dhammajātaṃ	धम्मजातं
dhammakathaṃ	धम्मकथं
dhammakathika	धम्मकथिक
dhammakathikoti	धम्मकथिकोति
dhammakathikā	धम्मकथिका
dhammakkhandhagaṇanā	धम्मक्खन्धगणना
dhammakkhandhasahassāni	धम्मक्खन्धसहस्सानि
dhammakkhandhasahassānīti	धम्मक्खन्धसहस्सानीति
dhammakkhandhato	धम्मक्खन्धतो
dhammakkhandho	धम्मक्खन्धो
dhammakkhandhoti	धम्मक्खन्धोति
dhammantaraṃ	धम्मन्तरं
dhammantarā	धम्मन्तरा
dhammapadesoti	धम्मपदेसोति
dhammapadādayo	धम्मपदादयो
dhammapaṭisambhidāti	धम्मपटिसम्भिदाति
dhammapuñjamatte	धम्मपुञ्जमत्ते
dhammasavanatthāya	धम्मसवनत्थाय
dhammasaṅgaṇiṃ	धम्मसङ्गणिं
dhammasaṅgaṇīpakaraṇaṃ	धम्मसङ्गणीपकरणं
dhammasaṅgaṇīpakaraṇe	धम्मसङ्गणीपकरणे
dhammasaṅgaṇīvibhaṅgadhātukathāpuggalapaññattikathāvatthuyamakapaṭṭhānānaṃ	धम्मसङ्गणीविभङ्गधातुकथापुग्गलपञ्ञत्तिकथावत्थुयमकपट्ठानानं
dhammaseno	धम्मसेनो
dhammasenāpati	धम्मसेनापति
dhammassāmī	धम्मस्सामी
dhammato	धम्मतो
dhammatthadesanāpaṭivedhagambhīrabhāvo	धम्मत्थदेसनापटिवेधगम्भीरभावो
dhammatthadesanāpaṭivedhā	धम्मत्थदेसनापटिवेधा
dhammayamakaṃ	धम्मयमकं
dhammaṃ	धम्मं
dhamme	धम्मे
dhammesu	धम्मेसु
dhammikaanavajjabhāvo	धम्मिकअनवज्जभावो
dhammikapabbataṃ	धम्मिकपब्बतं
dhammikapabbate	धम्मिकपब्बते
dhammiko	धम्मिको
dhammiyo	धम्मियो
dhammo	धम्मो
dhammā	धम्मा
dhammābhilāpoti	धम्माभिलापोति
dhammābhisamayo	धम्माभिसमयो
dhammānanti	धम्मानन्ति
dhammānaṃ	धम्मानं
dhammānurūpaṃ	धम्मानुरूपं
dhammāpe	धम्मापे
dhammāti	धम्माति
dhammātirekadhammavisesaṭṭhena	धम्मातिरेकधम्मविसेसट्ठेन
dhammātiādinā	धम्मातिआदिना
dhammāyatane	धम्मायतने
dhammī	धम्मी
dhanadhaññapariggahābhāvo	धनधञ्ञपरिग्गहाभावो
dhanasāraṃ	धनसारं
dhanavatī	धनवती
dhanañcayarājakāle	धनञ्चयराजकाले
dhanaṃ	धनं
dhaññanibbattakaṃ	धञ्ञनिब्बत्तकं
dhaññavatī	धञ्ञवती
dhaññaṃ	धञ्ञं
dhenu	धेनु
dhovitabbo	धोवितब्बो
dhoviyamānepi	धोवियमानेपि
dhovāpetvā	धोवापेत्वा
dhuragāme	धुरगामे
dhuvasassataṃ	धुवसस्सतं
dhuvassavaṃ	धुवस्सवं
dhuvaṃ	धुवं
dhārayantesu	धारयन्तेसु
dhāraṇe	धारणे
dhārenti	धारेन्ति
dhārentī	धारेन्ती
dhāretuṃ	धारेतुं
dhāreyyāthāti	धारेय्याथाति
dhārito	धारितो
dhātukathaṃ	धातुकथं
dhātukathāpakaraṇaṃ	धातुकथापकरणं
dhātupadeso	धातुपदेसो
dhātupaññatti	धातुपञ्ञत्ति
dhātuvibhaṅgo	धातुविभङ्गो
dhātuyamakaṃ	धातुयमकं
dhātuyo	धातुयो
dhātuāyatanāna	धातुआयतनान
dhātvantaraṃ	धात्वन्तरं
dhīrapurisehi	धीरपुरिसेहि
dibbacakkhunā	दिब्बचक्खुना
dibbagandhapupphehi	दिब्बगन्धपुप्फेहि
dibbagandho	दिब्बगन्धो
dibbamandāravapadumapāricchattakapupphāni	दिब्बमन्दारवपदुमपारिच्छत्तकपुप्फानि
dibbasampattiṃ	दिब्बसम्पत्तिं
dibbatūriyehi	दिब्बतूरियेहि
dibbehi	दिब्बेहि
dibbā	दिब्बा
dinnakāle	दिन्नकाले
dinnanayena	दिन्ननयेन
dinnaṃ	दिन्नं
disaṃ	दिसं
dissanti	दिस्सन्ति
dissati	दिस्सति
disvā	दिस्वा
disvāna	दिस्वान
disvāpi	दिस्वापि
disā	दिसा
disābhāgā	दिसाभागा
disāsu	दिसासु
disāya	दिसाय
divasabhāgaṃ	दिवसभागं
divasehi	दिवसेहि
divasesu	दिवसेसु
divāvihāraṃ	दिवाविहारं
divāvihārāya	दिवाविहाराय
diyaḍḍhakilesasahassaṃ	दियड्ढकिलेससहस्सं
diyaḍḍharatanaṃ	दियड्ढरतनं
diyaḍḍhasataṃ	दियड्ढसतं
diṭṭhiviniveṭhanakathā	दिट्ठिविनिवेठनकथा
diṭṭhiviniveṭhanā	दिट्ठिविनिवेठना
diṭṭhosi	दिट्ठोसि
diṭṭhā	दिट्ठा
domanassaṃ	दोमनस्सं
domanassindriyaṃ	दोमनस्सिन्द्रियं
dose	दोसे
doso	दोसो
dosoti	दोसोति
dosā	दोसा
dosānurūpaṃ	दोसानुरूपं
duccaritasaṃkilesassa	दुच्चरितसंकिलेसस्स
duggahitattā	दुग्गहितत्ता
duggahitaṃ	दुग्गहितं
duggahitena	दुग्गहितेन
duggahitā	दुग्गहिता
duggatiṃ	दुग्गतिं
dukadukapaṭṭhānaṃ	दुकदुकपट्ठानं
dukadukañca	दुकदुकञ्च
dukamātikā	दुकमातिका
dukapaṭṭhānaṃ	दुकपट्ठानं
dukasataṃ	दुकसतं
dukasate	दुकसते
dukatikapaṭṭhānaṃ	दुकतिकपट्ठानं
duke	दुके
dukesuyeva	दुकेसुयेव
dukhaṃ	दुखं
dukhaṭṭito	दुखट्टितो
dukhā	दुखा
dukkarakārikaṃ	दुक्करकारिकं
dukkathitaṃ	दुक्कथितं
dukkhasaccaṃ	दुक्खसच्चं
dukkhasacce	दुक्खसच्चे
dukkhassa	दुक्खस्स
dukkhato	दुक्खतो
dukkhaṃ	दुक्खं
dukkhe	दुक्खे
dukkhito	दुक्खितो
dukkhogāhaṃ	दुक्खोगाहं
dukkhogāhā	दुक्खोगाहा
dukkhā	दुक्खा
dukkhāya	दुक्खाय
dukuttamaṃ	दुकुत्तमं
dukā	दुका
dukāti	दुकाति
dullabhā	दुल्लभा
dumā	दुमा
duppaññehi	दुप्पञ्ञेहि
duppaṭipanno	दुप्पटिपन्नो
durabhisambhavabhāvo	दुरभिसम्भवभावो
dussayugāni	दुस्सयुगानि
dussīlabhāvamicchādiṭṭhitācittakkhepappabhedaṃ	दुस्सीलभावमिच्छादिट्ठिताचित्तक्खेपप्पभेदं
dussīlabhāvaṃ	दुस्सीलभावं
dutiyakavāso	दुतियकवासो
dutiyaṃ	दुतियं
dutiye	दुतिये
dutiyo	दुतियो
duvidhatthena	दुविधत्थेन
duvidhenātiādinā	दुविधेनातिआदिना
dvattiṃsa	द्वत्तिंस
dve	द्वे
dvenavutikappamatthake	द्वेनवुतिकप्पमत्थके
dvepi	द्वेपि
dvibhāṇavāramatto	द्विभाणवारमत्तो
dvimattabhāṇavāraṃ	द्विमत्तभाणवारं
dvimattabhāṇavāro	द्विमत्तभाणवारो
dvinnaṃ	द्विन्नं
dvācattālīsa	द्वाचत्तालीस
dvādasa	द्वादस
dvādasaguṇamupāgataṃ	द्वादसगुणमुपागतं
dvādasahi	द्वादसहि
dvādasamoti	द्वादसमोति
dvādasapadiko	द्वादसपदिको
dvādasayojane	द्वादसयोजने
dvādasānisaṃsā	द्वादसानिसंसा
dvādasāyatanāni	द्वादसायतनानि
dvārato	द्वारतो
dvāsaṭṭhi	द्वासट्ठि
dvāsaṭṭhidiṭṭhipaṭipakkhabhūtā	द्वासट्ठिदिट्ठिपटिपक्खभूता
dvāsīti	द्वासीति
dvāvīsati	द्वावीसति
dvāvīsatitike	द्वावीसतितिके
dvāvīsatiyā	द्वावीसतिया
dvīsu	द्वीसु
dāmā	दामा
dāmāni	दामानि
dānabalā	दानबला
dānajjhāsayataṃ	दानज्झासयतं
dānanti	दानन्ति
dānapāraminti	दानपारमिन्ति
dānapāramitā	दानपारमिता
dānapāramitādayo	दानपारमितादयो
dānapāramitāya	दानपारमिताय
dānapāramiṃ	दानपारमिं
dānapāramīti	दानपारमीति
dānaṃ	दानं
dāni	दानि
dārake	दारके
dāsako	दासको
dātuṃ	दातुं
dātā	दाता
dī	दी
dīghamaddhānaṃ	दीघमद्धानं
dīghamajjhimanikāyappamāṇā	दीघमज्झिमनिकायप्पमाणा
dīghanikāyappamāṇaṃ	दीघनिकायप्पमाणं
dīghanikāyo	दीघनिकायो
dīghanikāyope	दीघनिकायोपे
dīghanikāyoti	दीघनिकायोति
dīgharattaṃ	दीघरत्तं
dīghasuttaṃ	दीघसुत्तं
dīghato	दीघतो
dīghaādike	दीघआदिके
dīpappasādakamahāmahindattherassa	दीपप्पसादकमहामहिन्दत्थेरस्स
dīparukkhova	दीपरुक्खोव
dīpavāsīnaṃ	दीपवासीनं
dīpayanto	दीपयन्तो
dīpaṃ	दीपं
dīpaṅkaradasabalato	दीपङ्करदसबलतो
dīpaṅkaramupāgamuṃ	दीपङ्करमुपागमुं
dīpaṅkarapādamūlato	दीपङ्करपादमूलतो
dīpaṅkarapādamūle	दीपङ्करपादमूले
dīpaṅkarasanāmako	दीपङ्करसनामको
dīpaṅkarassa	दीपङ्करस्स
dīpaṅkaro	दीपङ्करो
dīpaṅkarādīnaṃ	दीपङ्करादीनं
dīpeti	दीपेति
dūrenidānaṃ	दूरेनिदानं
ehi	एहि
ekadeseneva	एकदेसेनेव
ekadivasaṃyeva	एकदिवसंयेव
ekadivasepi	एकदिवसेपि
ekaggataṃ	एकग्गतं
ekakahāpaṇampi	एककहापणम्पि
ekakato	एककतो
ekamantaṃ	एकमन्तं
ekamekasmiṃ	एकमेकस्मिं
ekamekañca	एकमेकञ्च
ekamekaṃ	एकमेकं
ekameko	एकमेको
ekameva	एकमेव
ekanavutikappe	एकनवुतिकप्पे
ekandhakārāni	एकन्धकारानि
ekanikāyampi	एकनिकायम्पि
ekanipātadukanipātasaṅgīti	एकनिपातदुकनिपातसङ्गीति
ekantadhammakathiko	एकन्तधम्मकथिको
ekantarikā	एकन्तरिका
ekantato	एकन्ततो
ekapallaṅkena	एकपल्लङ्केन
ekappahāreneva	एकप्पहारेनेव
ekasatasahassaṃ	एकसतसहस्सं
ekasataṃ	एकसतं
ekasmiṃ	एकस्मिं
ekasmiṃyeva	एकस्मिंयेव
ekassa	एकस्स
ekatiṃsakappe	एकतिंसकप्पे
ekatiṃse	एकतिंसे
ekato	एकतो
ekavidhena	एकविधेन
ekavīsatiyā	एकवीसतिया
ekaṃ	एकं
ekaṃsaṃ	एकंसं
ekekā	एकेका
ekena	एकेन
ekissā	एकिस्सा
eko	एको
ekokāsaṃ	एकोकासं
ekoti	एकोति
ekova	एकोव
ekādasa	एकादस
ekādasamo	एकादसमो
ekānusandhikaṃ	एकानुसन्धिकं
ekūnanavuti	एकूननवुति
esa	एस
esantassa	एसन्तस्स
eseva	एसेव
esevanto	एसेवन्तो
eso	एसो
esā	एसा
etadahosi	एतदहोसि
etamatthaṃ	एतमत्थं
etassa	एतस्स
etasseva	एतस्सेव
etaṃ	एतं
ete	एते
eteheva	एतेहेव
etena	एतेन
eteneva	एतेनेव
etesu	एतेसु
etha	एथ
ettakampi	एत्तकम्पि
ettakaṃ	एत्तकं
ettake	एत्तके
ettakenapi	एत्तकेनपि
ettako	एत्तको
ettakā	एत्तका
ettakānañhi	एत्तकानञ्हि
ettakānaṃ	एत्तकानं
ettakāni	एत्तकानि
ettakāyeva	एत्तकायेव
ettha	एत्थ
etthāyaṃ	एत्थायं
etto	एत्तो
etāni	एतानि
eva	एव
evamassāpi	एवमस्सापि
evametampi	एवमेतम्पि
evamete	एवमेते
evametena	एवमेतेन
evameva	एवमेव
evamevaṃ	एवमेवं
evamādīhi	एवमादीहि
evamāha	एवमाह
evarūpaṃ	एवरूपं
evarūpe	एवरूपे
evarūpena	एवरूपेन
evarūpo	एवरूपो
evaṃ	एवं
gabbhe	गब्भे
gaccha	गच्छ
gacchantaṃ	गच्छन्तं
gacchanti	गच्छन्ति
gacchanto	गच्छन्तो
gacchantā	गच्छन्ता
gacchati	गच्छति
gacchatu	गच्छतु
gacchatīti	गच्छतीति
gaccheyya	गच्छेय्य
gaccheyyaṃ	गच्छेय्यं
gacchissaṃ	गच्छिस्सं
gacchāmi	गच्छामि
gaganamaṇḍale	गगनमण्डले
gaganatalaṃ	गगनतलं
gaganatale	गगनतले
gaganā	गगना
gahakūṭaṃ	गहकूटं
gahanacchannatā	गहनच्छन्नता
gahetabbo	गहेतब्बो
gahetuṃ	गहेतुं
gahetvā	गहेत्वा
gahetvāna	गहेत्वान
gahitapaṭiñño	गहितपटिञ्ञो
gahitaṃ	गहितं
gamanakāraṇaṃ	गमनकारणं
gamanampathe	गमनम्पथे
gamanasamaye	गमनसमये
gambhīrabhāvavijānanatthaṃ	गम्भीरभावविजाननत्थं
gambhīrabhāvo	गम्भीरभावो
gambhīragataṃ	गम्भीरगतं
gambhīrañāṇehi	गम्भीरञाणेहि
gambhīraṃ	गम्भीरं
gambhīrā	गम्भीरा
gamissāmi	गमिस्सामि
gandhabbā	गन्धब्बा
gandhadāmamālādāmāni	गन्धदाममालादामानि
gandho	गन्धो
ganthentena	गन्थेन्तेन
ganthetvā	गन्थेत्वा
gantvā	गन्त्वा
garahapaṭicchādanabhāvo	गरहपटिच्छादनभावो
garahaṃ	गरहं
garahitā	गरहिता
garahāya	गरहाय
gatagataṭṭhāne	गतगतट्ठाने
gate	गते
gato	गतो
gatā	गता
gavapānaṃ	गवपानं
gavesantassa	गवेसन्तस्स
gavesanto	गवेसन्तो
gavesati	गवेसति
gaṇanacāraṃ	गणनचारं
gaṇanacāropi	गणनचारोपि
gaṇanā	गणना
gaṇanāto	गणनातो
gaṇena	गणेन
gaṇhantesu	गण्हन्तेसु
gaṇhanti	गण्हन्ति
gaṇhanto	गण्हन्तो
gaṇhatha	गण्हथ
gaṇhathāti	गण्हथाति
gaṇheyya	गण्हेय्य
gaṇheyyātha	गण्हेय्याथ
gaṇhi	गण्हि
gaṇhitthāti	गण्हित्थाति
gaṇhituṃ	गण्हितुं
gaṇhiṃ	गण्हिं
gaṇhiṃsu	गण्हिंसु
gaṇhāti	गण्हाति
gehasampadā	गेहसम्पदा
gehassa	गेहस्स
gehaṃ	गेहं
gehālayapaṭikkhepo	गेहालयपटिक्खेपो
geyya	गेय्य
geyyaṃ	गेय्यं
ghanakkhandho	घनक्खन्धो
ghanamahāpathaviṃ	घनमहापथविं
ghanapākapakke	घनपाकपक्के
gharāvāsaṃ	घरावासं
gharāvāse	घरावासे
gharāvāsena	घरावासेन
ghaṭakā	घटका
ghaṭento	घटेन्तो
ghaṭikārassa	घटिकारस्स
ghositaṃ	घोसितं
gihibandhanaṃ	गिहिबन्धनं
girikandarānusārena	गिरिकन्दरानुसारेन
gocarāya	गोचराय
gopetabbo	गोपेतब्बो
gosiṅgasālavanaṃ	गोसिङ्गसालवनं
gotamo	गोतमो
guṇasampatti	गुणसम्पत्ति
guṇaṃ	गुणं
guṇe	गुणे
guṇehi	गुणेहि
guṇo	गुणो
guṇā	गुणा
gāhāpetvā	गाहापेत्वा
gāmadārakesu	गामदारकेसु
gāmaṃ	गामं
gāthaṃ	गाथं
gāthā	गाथा
gāthāsahassāni	गाथासहस्सानि
gāthāyo	गाथायो
gīvato	गीवतो
gīvaṃ	गीवं
gūthagato	गूथगतो
hadayamaṃsaṃ	हदयमंसं
handa	हन्द
hasanti	हसन्ति
hatthagataṃ	हत्थगतं
hatthaṃ	हत्थं
hatthe	हत्थे
hatthena	हत्थेन
hatthippamāṇaṃ	हत्थिप्पमाणं
hatthipālakumārakāle	हत्थिपालकुमारकाले
hatthiratanaṃ	हत्थिरतनं
hatthāḷavako	हत्थाळवको
hatā	हता
have	हवे
haṃsavatī	हंसवती
haṭṭhapahaṭṭho	हट्ठपहट्ठो
hehiti	हेहिति
hesa	हेस
hessanti	हेस्सन्ति
hessantupaṭṭhakā	हेस्सन्तुपट्ठका
hessantupaṭṭhikā	हेस्सन्तुपट्ठिका
hessati	हेस्सति
hessaṃ	हेस्सं
hessāma	हेस्साम
hetaṃ	हेतं
hete	हेते
hettha	हेत्थ
hetu	हेतु
hetumhi	हेतुम्हि
hetupaccayo	हेतुपच्चयो
hetuphalaṃ	हेतुफलं
hetuphale	हेतुफले
hetuye	हेतुये
hetū	हेतू
heṭṭhā	हेट्ठा
heṭṭhālohapāsāde	हेट्ठालोहपासादे
hi	हि
hidaṃ	हिदं
himavantamupāgamiṃ	हिमवन्तमुपागमिं
himavantapāde	हिमवन्तपादे
himavantaṃ	हिमवन्तं
hitāhite	हिताहिते
hitāya	हिताय
hohi	होहि
homi	होमि
honti	होन्ति
hontāvaraṇā	होन्तावरणा
hotha	होथ
hoti	होति
hotiyeva	होतियेव
hotu	होतु
hotīti	होतीति
hotītiādinā	होतीतिआदिना
hutvā	हुत्वा
hāso	हासो
hāvuso	हावुसो
hīnamukkaṭṭhamajjhime	हीनमुक्कट्ठमज्झिमे
hīraṃ	हीरं
icchitabbakaṃ	इच्छितब्बकं
icchitabbako	इच्छितब्बको
idamassa	इदमस्स
idaṃ	इदं
iddhaṃ	इद्धं
iddhi	इद्धि
iddhidhammesu	इद्धिधम्मेसु
iddhimayapattacīvaradharā	इद्धिमयपत्तचीवरधरा
iddhimayapattacīvarassa	इद्धिमयपत्तचीवरस्स
iddhipādabojjhaṅgamaggaṅgavibhaṅgā	इद्धिपादबोज्झङ्गमग्गङ्गविभङ्गा
iddhipādavibhaṅgo	इद्धिपादविभङ्गो
iddhipādā	इद्धिपादा
idhekacce	इधेकच्चे
idhāgatāti	इधागताति
idhāvuso	इधावुसो
idriyavibhaṅgo	इद्रियविभङ्गो
idāni	इदानि
imameva	इममेव
imasmiṃ	इमस्मिं
imasmā	इमस्मा
imassa	इमस्स
imaṃ	इमं
ime	इमे
imesaṃ	इमेसं
imesu	इमेसु
iminā	इमिना
imināva	इमिनाव
imissā	इमिस्सा
imāni	इमानि
imāya	इमाय
indriyantaraṃ	इन्द्रियन्तरं
indriyapaccayo	इन्द्रियपच्चयो
indriyapadeso	इन्द्रियपदेसो
indriyapaññatti	इन्द्रियपञ्ञत्ति
indriyavibhaṅge	इन्द्रियविभङ्गे
indriyayamakanti	इन्द्रिययमकन्ति
indriyāni	इन्द्रियानि
isayo	इसयो
isipabbajjaṃ	इसिपब्बज्जं
isipatane	इसिपतने
isīhi	इसीहि
itaresu	इतरेसु
iti	इति
itihāse	इतिहासे
itivu	इतिवु
itivuttaka	इतिवुत्तक
itivuttakaṃ	इतिवुत्तकं
itivādappamokkhānisaṃsā	इतिवादप्पमोक्खानिसंसा
ito	इतो
itopi	इतोपि
iṅgha	इङ्घ
iṭṭiyo	इट्टियो
jaccandhā	जच्चन्धा
jahanti	जहन्ति
jajjaraṃ	जज्जरं
jalamajjhe	जलमज्झे
jalasāgaro	जलसागरो
jambudīpatale	जम्बुदीपतले
janakāyaṃ	जनकायं
janasandho	जनसन्धो
janataṃ	जनतं
janaṃ	जनं
jane	जने
janesi	जनेसि
janeti	जनेति
janettiyā	जनेत्तिया
janikā	जनिका
jarādhammo	जराधम्मो
jayaddisarājaputtakāle	जयद्दिसराजपुत्तकाले
jayaseno	जयसेनो
jayasumanapāribhaddakabandhujīvakakusumasamparikiṇṇā	जयसुमनपारिभद्दकबन्धुजीवककुसुमसम्परिकिण्णा
jaṭilaṃ	जटिलं
jaṭilo	जटिलो
jaṭāmaṇḍalavākacīratidaṇḍakuṇḍikādike	जटामण्डलवाकचीरतिदण्डकुण्डिकादिके
jaṭāmaṇḍalaṃ	जटामण्डलं
jhānapaccayo	झानपच्चयो
jhānapadeso	झानपदेसो
jhānaratisamappito	झानरतिसमप्पितो
jhānavibhaṅgo	झानविभङ्गो
jhānaṅgesu	झानङ्गेसु
jhāne	झाने
jhānāni	झानानि
jhāpaye	झापये
jhāyato	झायतो
jighacchā	जिघच्छा
jigucchiya	जिगुच्छिय
jinabodhiyaṃ	जिनबोधियं
jinacakke	जिनचक्के
jinaputtā	जिनपुत्ता
jinasevitaṃ	जिनसेवितं
jinavacanabhūtā	जिनवचनभूता
jinaṃ	जिनं
jine	जिने
jino	जिनो
jinā	जिना
jitamitto	जितमित्तो
jivhā	जिव्हा
jiṇṇabyādhimatasaṅkhāte	जिण्णब्याधिमतसङ्खाते
jiṇṇanāvaṃva	जिण्णनावंव
jiṇṇassa	जिण्णस्स
jiṇṇepi	जिण्णेपि
jotanti	जोतन्ति
jotipālo	जोतिपालो
jā	जा
jālāpetvā	जालापेत्वा
jānanti	जानन्ति
jānantīti	जानन्तीति
jānaṃ	जानं
jānissāmīti	जानिस्सामीति
jānitunti	जानितुन्ति
jānituṃ	जानितुं
jānāma	जानाम
jānāmīti	जानामीति
jānāsīti	जानासीति
jānāti	जानाति
jānātīti	जानातीति
jātaka	जातक
jātakasatesu	जातकसतेसु
jātakasatāni	जातकसतानि
jātakasuttanipātadhammapadādīnaṃ	जातकसुत्तनिपातधम्मपदादीनं
jātakaṃ	जातकं
jātanagaraṃ	जातनगरं
jātasāsanaṃ	जातसासनं
jātaṃ	जातं
jāti	जाति
jātibhogayasaissariyādisampattīhi	जातिभोगयसइस्सरियादिसम्पत्तीहि
jātivādena	जातिवादेन
jātā	जाता
jāyante	जायन्ते
jīraṇabhāvo	जीरणभावो
jīvissasīti	जीविस्ससीति
jīvitapariccāgaṃ	जीवितपरिच्चागं
jīvitaṃ	जीवितं
kabaḷīkārāhārappaṭibaddhaṃ	कबळीकाराहारप्पटिबद्धं
kacchehi	कच्छेहि
kaccānenāti	कच्चानेनाति
kakudharukkhotipi	ककुधरुक्खोतिपि
kakusandho	ककुसन्धो
kalale	कलले
kalyāṇamapi	कल्याणमपि
kalyāṇamatha	कल्याणमथ
kalyāṇe	कल्याणे
kammakiriyadassanā	कम्मकिरियदस्सना
kammantaraṃ	कम्मन्तरं
kammapaccayo	कम्मपच्चयो
kammassa	कम्मस्स
kammaṃ	कम्मं
kammaṭṭhānaṃ	कम्मट्ठानं
kammākammaṃ	कम्माकम्मं
kampati	कम्पति
kampento	कम्पेन्तो
kampi	कम्पि
kampitā	कम्पिता
kandanto	कन्दन्तो
kapilavhayā	कपिलव्हया
kapotapādavaṇṇaṃ	कपोतपादवण्णं
kappakavesaṃ	कप्पकवेसं
kappakoṭisatehipi	कप्पकोटिसतेहिपि
kappasahassānaṃ	कप्पसहस्सानं
kappasatasahassādhikānaṃ	कप्पसतसहस्साधिकानं
kappasatasahassādhikāni	कप्पसतसहस्साधिकानि
kappasatasahassānaṃ	कप्पसतसहस्सानं
kappasatānaṃ	कप्पसतानं
kappe	कप्पे
kappemi	कप्पेमि
kappiyabhaṇḍaṃ	कप्पियभण्डं
kappiyanti	कप्पियन्ति
kappiyaparikkhārā	कप्पियपरिक्खारा
kappāsapacchiyaṃ	कप्पासपच्छियं
karaṇabhāvo	करणभावो
karaṇapariyesanabhāvo	करणपरियेसनभावो
kareyyaṃ	करेय्यं
karissasīti	करिस्ससीति
karissāmatthavaṇṇanaṃ	करिस्सामत्थवण्णनं
karissāmi	करिस्सामि
karissāmīti	करिस्सामीति
karontassa	करोन्तस्स
karonto	करोन्तो
karosīti	करोसीति
karoti	करोति
karīsaṃ	करीसं
kasiṇamaṇḍalaṃ	कसिणमण्डलं
kasiṇaparikammaṃ	कसिणपरिकम्मं
kasmā	कस्मा
kassa	कस्स
kassaci	कस्सचि
kassapadasabalassa	कस्सपदसबलस्स
kassapo	कस्सपो
katamo	कतमो
katanti	कतन्ति
kataparivāro	कतपरिवारो
katapāṭihāriyañca	कतपाटिहारियञ्च
katasanniṭṭhāno	कतसन्निट्ठानो
katassa	कतस्स
katayamakapāṭihāriyasadisameva	कतयमकपाटिहारियसदिसमेव
kataṃ	कतं
katena	कतेन
kathanaṃ	कथनं
kathayanto	कथयन्तो
kathaṃ	कथं
kathenti	कथेन्ति
kathento	कथेन्तो
kathentā	कथेन्ता
kathentāpi	कथेन्तापि
kathesi	कथेसि
kathessatīti	कथेस्सतीति
kathesīti	कथेसीति
kathetabbā	कथेतब्बा
kathetu	कथेतु
kathito	कथितो
kathitoti	कथितोति
kathitāti	कथिताति
kathā	कथा
kathāpavattinī	कथापवत्तिनी
kathāti	कथाति
kathāvatthu	कथावत्थु
kathāvatthunā	कथावत्थुना
kathāvatthunāva	कथावत्थुनाव
kathāvatthuppakaraṇaṃ	कथावत्थुप्पकरणं
kathāvatthuṃ	कथावत्थुं
katipayāni	कतिपयानि
katipayāva	कतिपयाव
kato	कतो
kattabbakiccanti	कत्तब्बकिच्चन्ति
kattabbakiccaṃ	कत्तब्बकिच्चं
kattaradaṇḍaṃ	कत्तरदण्डं
katvā	कत्वा
katvāna	कत्वान
katābhinīhārena	कताभिनीहारेन
katābhinīhārānaṃ	कताभिनीहारानं
kavāṭā	कवाटा
kañcanapabbatamhi	कञ्चनपब्बतम्हि
kañci	कञ्चि
kaṅkhā	कङ्खा
kaṇhapakkhasukkapakkhe	कण्हपक्खसुक्कपक्खे
kaṇikārarukkho	कणिकाररुक्खो
kaṇḍakaṃ	कण्डकं
kaṇḍambarukkhamūle	कण्डम्बरुक्खमूले
kaṇṭhe	कण्ठे
kaṭṭhattharikāya	कट्ठत्थरिकाय
ke	के
keci	केचि
kena	केन
kenaṭṭhena	केनट्ठेन
kesaggamattampi	केसग्गमत्तम्पि
kevalañca	केवलञ्च
kevalaṃ	केवलं
khajjopanako	खज्जोपनको
khamanti	खमन्ति
khanati	खनति
khandhabhāramahicchabhāvo	खन्धभारमहिच्छभावो
khandhakā	खन्धका
khandhantaraṃ	खन्धन्तरं
khandhapadeso	खन्धपदेसो
khandhapaññatti	खन्धपञ्ञत्ति
khandhato	खन्धतो
khandhavibhaṅgo	खन्धविभङ्गो
khandhayamakaṃ	खन्धयमकं
khandhā	खन्धा
khantipāramitā	खन्तिपारमिता
khantipāramiṃ	खन्तिपारमिं
khantipāramīti	खन्तिपारमीति
kharadāṭhiko	खरदाठिको
khattiye	खत्तिये
khattiyo	खत्तियो
khayamajjhagāti	खयमज्झगाति
khayaṃ	खयं
khaye	खये
khaṇe	खणे
khaṇo	खणो
khaṇḍo	खण्डो
khemaṃ	खेमं
khemaṅkaro	खेमङ्करो
khemo	खेमो
khemā	खेमा
khepetvā	खेपेत्वा
kheḷapiṇḍaṃ	खेळपिण्डं
kheḷapiṇḍaṃva	खेळपिण्डंव
khippaṃ	खिप्पं
khittaṃ	खित्तं
kho	खो
khuddakanikāyo	खुद्दकनिकायो
khuddakanikāyoti	खुद्दकनिकायोति
khuddakapāṭha	खुद्दकपाठ
khuddakavagguliyoniyaṃ	खुद्दकवग्गुलियोनियं
khuddakavatthuvibhaṅgo	खुद्दकवत्थुविभङ्गो
khuddako	खुद्दको
khuddakā	खुद्दका
khuppipāsā	खुप्पिपासा
khādanti	खादन्ति
khādi	खादि
khāditvā	खादित्वा
khārikājaṃ	खारिकाजं
khīrassa	खीरस्स
khīraṃ	खीरं
khīre	खीरे
khīṇāsavo	खीणासवो
khīṇāsavā	खीणासवा
kilantarūpā	किलन्तरूपा
kilesabyādhīhi	किलेसब्याधीहि
kilesamaladhove	किलेसमलधोवे
kilesapariruddho	किलेसपरिरुद्धो
kilesappahāne	किलेसप्पहाने
kilese	किलेसे
kilesā	किलेसा
kilesānaṃ	किलेसानं
kilissanabhāvo	किलिस्सनभावो
kilissanti	किलिस्सन्ति
kilissati	किलिस्सति
kiliṭṭho	किलिट्ठो
kira	किर
kiriyato	किरियतो
kismiñci	किस्मिञ्चि
kissa	किस्स
kittakehi	कित्तकेहि
kittako	कित्तको
kittakā	कित्तका
kiṃ	किं
kiṅkiṇikajālaṃ	किङ्किणिकजालं
ko	को
koci	कोचि
kolambe	कोलम्बे
kopānunayavajjitā	कोपानुनयवज्जिता
kosiyaputto	कोसियपुत्तो
koṇe	कोणे
koṇāgamano	कोणागमनो
koṇḍañño	कोण्डञ्ञो
koṭi	कोटि
koṭisahassaṃ	कोटिसहस्सं
koṭisatabhikkhū	कोटिसतभिक्खू
koṭisatakhīṇāsavā	कोटिसतखीणासवा
koṭisatamabodhayi	कोटिसतमबोधयि
koṭisatasahassabhikkhuparivārassa	कोटिसतसहस्सभिक्खुपरिवारस्स
koṭisatasahassabhikkhū	कोटिसतसहस्सभिक्खू
koṭisatasahassadhanapariccāgena	कोटिसतसहस्सधनपरिच्चागेन
koṭisatasahassanti	कोटिसतसहस्सन्ति
koṭisatasahassasaṅkhassa	कोटिसतसहस्ससङ्खस्स
koṭisatasahassasaṅkhyānaṃ	कोटिसतसहस्ससङ्ख्यानं
koṭisatasahassaṃ	कोटिसतसहस्सं
koṭisataṃ	कोटिसतं
koṭiyaṃ	कोटियं
koṭṭente	कोट्टेन्ते
koṭṭhāsaṃ	कोट्ठासं
koṭṭhāso	कोट्ठासो
koṭṭiyantopi	कोट्टियन्तोपि
kudālapaṇḍitakāle	कुदालपण्डितकाले
kudālapiṭakaṃādāyātiādīsu	कुदालपिटकंआदायातिआदीसु
kulaparivaṭṭā	कुलपरिवट्टा
kulaputtānaṃ	कुलपुत्तानं
kulaṃ	कुलं
kumbhakārassa	कुम्भकारस्स
kumbho	कुम्भो
kumbhīnañca	कुम्भीनञ्च
kumāra	कुमार
kundakumudasinduvārasumanamallikādikusumasañchannā	कुन्दकुमुदसिन्दुवारसुमनमल्लिकादिकुसुमसञ्छन्ना
kuppāmi	कुप्पामि
kusalacchedanābhayā	कुसलच्छेदनाभया
kusalavipākato	कुसलविपाकतो
kusalaṃ	कुसलं
kusalā	कुसला
kusumānaṃ	कुसुमानं
kutopabhavā	कुतोपभवा
kuṅkumacuṇṇakaṇikārapupphasamparikiṇṇā	कुङ्कुमचुण्णकणिकारपुप्फसम्परिकिण्णा
kuṇapaṃ	कुणपं
kuṇḍikaṃ	कुण्डिकं
kuṭileṇacaṅkamādipaṭimaṇḍitaṃ	कुटिलेणचङ्कमादिपटिमण्डितं
kuṭiṃ	कुटिं
kāci	काचि
kāhasi	काहसि
kājakoṭiyā	काजकोटिया
kālakañjikā	कालकञ्जिका
kālamakaṃsu	कालमकंसु
kālaṃ	कालं
kālaṅkatabhāvaṃ	कालङ्कतभावं
kāle	काले
kālo	कालो
kāmāvacarakusalato	कामावचरकुसलतो
kāraṇā	कारणा
kāraṇāni	कारणानि
kāreti	कारेति
kāretvā	कारेत्वा
kārito	कारितो
kārāpetvā	कारापेत्वा
kāsi	कासि
kāsipuraṃ	कासिपुरं
kātabbaṃ	कातब्बं
kātunti	कातुन्ति
kātuṃ	कातुं
kāya	काय
kāyasakkhiṃ	कायसक्खिं
kāyassa	कायस्स
kāyavācānañca	कायवाचानञ्च
kāyavācānaṃ	कायवाचानं
kāyaṃ	कायं
kāye	काये
kāyo	कायो
kāyā	काया
kāḷena	काळेन
labhassu	लभस्सु
labhati	लभति
labhatīti	लभतीति
labhi	लभि
labhissāmi	लभिस्सामि
labhāmīti	लभामीति
laddhabyākaraṇo	लद्धब्याकरणो
laddhaticīvarasāṭakā	लद्धतिचीवरसाटका
laddhokāsena	लद्धोकासेन
laddhā	लद्धा
laganaṃ	लगनं
laggitaṃ	लग्गितं
lahukaṃ	लहुकं
lahuko	लहुको
lahuparivattaṃ	लहुपरिवत्तं
lahuṃ	लहुं
lajjatīti	लज्जतीति
lakkhaṇe	लक्खणे
lakkhaṇīyattā	लक्खणीयत्ता
latāpupphāni	लतापुप्फानि
leḍḍu	लेड्डु
likhitaṃ	लिखितं
liṅgasampatti	लिङ्गसम्पत्ति
liṅgato	लिङ्गतो
liṅgatoti	लिङ्गतोति
liṅgena	लिङ्गेन
lohitacandanena	लोहितचन्दनेन
lohitadhāraṃ	लोहितधारं
lohitarasmiyo	लोहितरस्मियो
lohitaṃ	लोहितं
lokadhātuyo	लोकधातुयो
lokadhātuṃ	लोकधातुं
lokadhātū	लोकधातू
lokantaresu	लोकन्तरेसु
lokanāthassa	लोकनाथस्स
lokanāyakaṃ	लोकनायकं
lokanāyake	लोकनायके
lokanāyako	लोकनायको
lokasmintiādīsu	लोकस्मिन्तिआदीसु
lokassa	लोकस्स
lokato	लोकतो
lokatthacariyāyo	लोकत्थचरियायो
lokaviduṃ	लोकविदुं
lokavidū	लोकविदू
lokaṃ	लोकं
loke	लोके
lokiyalokuttaro	लोकियलोकुत्तरो
loko	लोको
lokuttarakusalato	लोकुत्तरकुसलतो
lokuttarā	लोकुत्तरा
lokā	लोका
lomakūpamattampi	लोमकूपमत्तम्पि
ma	म
madhupiṇḍikasuttantādīni	मधुपिण्डिकसुत्तन्तादीनि
madhuradhammakathaṃ	मधुरधम्मकथं
madhurasaddo	मधुरसद्दो
madhurasalilāsayaṃ	मधुरसलिलासयं
madhuro	मधुरो
magadharājena	मगधराजेन
maggapaccayo	मग्गपच्चयो
maggasaccaṃ	मग्गसच्चं
maggaṃ	मग्गं
maggaṅgavibhaṅgo	मग्गङ्गविभङ्गो
maggo	मग्गो
mahagghabhāvo	महग्घभावो
mahallakassa	महल्लकस्स
mahantaṃ	महन्तं
mahante	महन्ते
mahantena	महन्तेन
mahanto	महन्तो
mahesino	महेसिनो
mahesīhi	महेसीहि
mahiddhikabhāvaṃ	महिद्धिकभावं
mahiddhiko	महिद्धिको
mahiddhikā	महिद्धिका
mahindenetamuttamaṃ	महिन्देनेतमुत्तमं
mahindo	महिन्दो
mahiyā	महिया
mahodadhiṃ	महोदधिं
mahosadhapaṇḍitakāleti	महोसधपण्डितकालेति
mahābhinikkhamanaṃ	महाभिनिक्खमनं
mahābhittiyaṃ	महाभित्तियं
mahābhogo	महाभोगो
mahābodhimaṇḍe	महाबोधिमण्डे
mahābodhinidāno	महाबोधिनिदानो
mahābodhipallaṅke	महाबोधिपल्लङ्के
mahābodhipallaṅkā	महाबोधिपल्लङ्का
mahābodhiṃ	महाबोधिं
mahābrahmāpi	महाब्रह्मापि
mahācaṅkame	महाचङ्कमे
mahācorasamo	महाचोरसमो
mahādhātukathā	महाधातुकथा
mahādukkhaṃ	महादुक्खं
mahādānañca	महादानञ्च
mahādānaṃ	महादानं
mahāgatigamiyatissadattatthero	महागतिगमियतिस्सदत्तत्थेरो
mahāgovindakāle	महागोविन्दकाले
mahāgovindapaṇḍitakāle	महागोविन्दपण्डितकाले
mahājambuphalaṃ	महाजम्बुफलं
mahājanakajātake	महाजनकजातके
mahājanassa	महाजनस्स
mahājanaṃ	महाजनं
mahājano	महाजनो
mahākaccānattheraṃ	महाकच्चानत्थेरं
mahākaccānena	महाकच्चानेन
mahākaccāno	महाकच्चानो
mahākassapappamukhena	महाकस्सपप्पमुखेन
mahākassapattherena	महाकस्सपत्थेरेन
mahākassapādīhi	महाकस्सपादीहि
mahāmoggallānattherassa	महामोग्गल्लानत्थेरस्स
mahāmukhaṃ	महामुखं
mahāmuni	महामुनि
mahānadiṃ	महानदिं
mahānubhāvo	महानुभावो
mahānāgehi	महानागेहि
mahānīparukkho	महानीपरुक्खो
mahāpadhānaṃ	महापधानं
mahāpakaraṇaṃ	महापकरणं
mahāpakaraṇe	महापकरणे
mahāpakaraṇeyeva	महापकरणेयेव
mahāpakaraṇiyā	महापकरणिया
mahāpathaviyā	महापथविया
mahāpathaviṃ	महापथविं
mahāpathavī	महापथवी
mahāpathavīkampanāni	महापथवीकम्पनानि
mahāpathaṃ	महापथं
mahāpañño	महापञ्ञो
mahāpaññā	महापञ्ञा
mahāpurisassa	महापुरिसस्स
mahāpurisaṃ	महापुरिसं
mahāpuriso	महापुरिसो
mahāpuññāni	महापुञ्ञानि
mahāpīṭhaṃ	महापीठं
mahārajjaṃ	महारज्जं
mahārajjāni	महारज्जानि
mahāraṭṭhiyo	महारट्ठियो
mahāsampattiyā	महासम्पत्तिया
mahāsamuddassa	महासमुद्दस्स
mahāsamuddaṃ	महासमुद्दं
mahāsamudde	महासमुद्दे
mahāsamuddeyeva	महासमुद्देयेव
mahāsamuddo	महासमुद्दो
mahāsamuddova	महासमुद्दोव
mahāsamārambhena	महासमारम्भेन
mahāsattassa	महासत्तस्स
mahāsattañhi	महासत्तञ्हि
mahāsattaṃ	महासत्तं
mahāsatto	महासत्तो
mahāsirīsarukkho	महासिरीसरुक्खो
mahāsoṇarukkho	महासोणरुक्खो
mahāsudassanarājakāle	महासुदस्सनराजकाले
mahāsākhāhi	महासाखाहि
mahāudakakkhandhotveva	महाउदकक्खन्धोत्वेव
mahāva	महाव
mahāvanasaṇḍavāsīnaṃ	महावनसण्डवासीनं
mahāvanasaṇḍe	महावनसण्डे
mahāveḷurukkho	महावेळुरुक्खो
mahāvilokanāni	महाविलोकनानि
mahāvīra	महावीर
mahāvīro	महावीरो
mahāyasaṃ	महायसं
mahāyaso	महायसो
mahītalaṃ	महीतलं
majjhe	मज्झे
majjhimabuddhavacanaṃ	मज्झिमबुद्धवचनं
majjhimanikāyo	मज्झिमनिकायो
majjhimayāme	मज्झिमयामे
majjhimo	मज्झिमो
mama	मम
mamaṃ	ममं
mamokāsaṃ	ममोकासं
mamāti	ममाति
manasā	मनसा
manasādesanā	मनसादेसना
mandabuddhīhi	मन्दबुद्धीहि
mandacchiddo	मन्दच्छिद्दो
mandavāteritassa	मन्दवातेरितस्स
mandāravapupphacchattaṃ	मन्दारवपुप्फच्छत्तं
mandāravaṃ	मन्दारवं
mano	मनो
manoramaṃ	मनोरमं
manoratho	मनोरथो
manosilātale	मनोसिलातले
mantadharo	मन्तधरो
mantetvā	मन्तेत्वा
manujindotiādīsu	मनुजिन्दोतिआदीसु
manussabhūtena	मनुस्सभूतेन
manussagaṇanāya	मनुस्सगणनाय
manussaloke	मनुस्सलोके
manusse	मनुस्से
manussesu	मनुस्सेसु
manussā	मनुस्सा
manussānaṃ	मनुस्सानं
manussāpi	मनुस्सापि
manāpā	मनापा
maraṇamattaṃ	मरणमत्तं
maraṇaṃ	मरणं
marū	मरू
matoti	मतोति
matthakaṃ	मत्थकं
matthake	मत्थके
mayaṃ	मयं
mayha	मय्ह
mayhanti	मय्हन्ति
mayhaṃ	मय्हं
mayā	मया
mayāpi	मयापि
maññe	मञ्ञे
maṃ	मं
maṅgalapokkharaṇītīre	मङ्गलपोक्खरणीतीरे
maṅgalasuttaratanasuttanālakasuttatuvaṭṭakasuttāni	मङ्गलसुत्तरतनसुत्तनालकसुत्ततुवट्टकसुत्तानि
maṅgalo	मङ्गलो
maṇimayā	मणिमया
maṇiratanaṃ	मणिरतनं
maṇitthambhesu	मणित्थम्भेसु
maṇḍapassa	मण्डपस्स
maṇḍapaṃ	मण्डपं
maṇḍape	मण्डपे
maṇḍapo	मण्डपो
me	मे
medinī	मेदिनी
mekhalaṃ	मेखलं
mettāpāramitā	मेत्तापारमिता
mettāpāramiṃ	मेत्तापारमिं
mettāsahagatena	मेत्तासहगतेन
mettāya	मेत्ताय
mettāyantassa	मेत्तायन्तस्स
micchādiṭṭhitaṃ	मिच्छादिट्ठितं
micchāvitakkamakkhikā	मिच्छावितक्कमक्खिका
migadāye	मिगदाये
migarājā	मिगराजा
milāyanti	मिलायन्ति
mitto	मित्तो
mocayiṃ	मोचयिं
moggaliputtatissattherenetaṃ	मोग्गलिपुत्ततिस्सत्थेरेनेतं
moggaliputtatissatthero	मोग्गलिपुत्ततिस्सत्थेरो
moggaliputto	मोग्गलिपुत्तो
moggallānenāti	मोग्गल्लानेनाति
moggallāno	मोग्गल्लानो
moghapurisā	मोघपुरिसा
moho	मोहो
morapiñchakalāpo	मोरपिञ्छकलापो
muccanti	मुच्चन्ति
mucchitā	मुच्छिता
mudukā	मुदुका
mudutalaṃ	मुदुतलं
muggavaṇṇasilaṃ	मुग्गवण्णसिलं
muggavaṇṇasilāpaṭṭe	मुग्गवण्णसिलापट्टे
muhuttaṃ	मुहुत्तं
mukhaṃ	मुखं
mukhādānaṃ	मुखादानं
muttimeva	मुत्तिमेव
muttāhāraṃ	मुत्ताहारं
muttājālasadisāya	मुत्ताजालसदिसाय
muñcitvā	मुञ्चित्वा
muñcitvāhaṃ	मुञ्चित्वाहं
muñcāmimaṃ	मुञ्चामिमं
muñjatiṇaṃ	मुञ्जतिणं
muḷālakalāpaṃ	मुळालकलापं
mā	मा
mālā	माला
mālāgandhūpahārādīhi	मालागन्धूपहारादीहि
mānamadapurisamade	मानमदपुरिसमदे
mānasaṃ	मानसं
mānusakaṃ	मानुसकं
mānusakā	मानुसका
mānusaṃ	मानुसं
mānusehi	मानुसेहि
mānusā	मानुसा
māpehīti	मापेहीति
māpesi	मापेसि
māpesinti	मापेसिन्ति
māpesiṃ	मापेसिं
māpetvā	मापेत्वा
māpitā	मापिता
mārabalaṃ	मारबलं
mārasenaṃ	मारसेनं
māreti	मारेति
māse	मासे
māsehi	मासेहि
mātaraṃ	मातरं
mātikaṃ	मातिकं
mātikā	मातिका
mātikāṭhapanaṃ	मातिकाठपनं
mātito	मातितो
mātu	मातु
mātukucchiyaṃ	मातुकुच्छियं
mātukucchiṃ	मातुकुच्छिं
mātā	माता
mātāpi	मातापि
mātāpitaro	मातापितरो
māyā	माया
māṇavo	माणवो
mūgapakkhikā	मूगपक्खिका
mūlapariyāyasuttādīni	मूलपरियायसुत्तादीनि
mūlato	मूलतो
mūlayamakaṃ	मूलयमकं
mūlādīhi	मूलादीहि
na	न
nabhe	नभे
nadanaṃ	नदनं
naditvā	नदित्वा
nadiyo	नदियो
nadiyā	नदिया
nadiṃ	नदिं
nadīnivattane	नदीनिवत्तने
nagaradvāresu	नगरद्वारेसु
nagaraṃ	नगरं
nagare	नगरे
nahetū	नहेतू
nakhāpi	नखापि
nakkhattā	नक्खत्ता
nakulā	नकुला
nalāṭaṃ	नलाटं
namassanti	नमस्सन्ति
namassitvā	नमस्सित्वा
nandamātā	नन्दमाता
nanti	नन्ति
nanu	ननु
napi	नपि
napihaṃ	नपिहं
nappahotiyeva	नप्पहोतियेव
nappakanti	नप्पकन्ति
nappaṭicchādeti	नप्पटिच्छादेति
naramarū	नरमरू
naranāriyo	नरनारियो
narā	नरा
narāsabho	नरासभो
natthi	नत्थि
natthipaccayo	नत्थिपच्चयो
natthīti	नत्थीति
nava	नव
navacchiddaṃ	नवच्छिद्दं
navadosamupāgata	नवदोसमुपागत
navadosamupāgataṃ	नवदोसमुपागतं
navamaṃ	नवमं
navamo	नवमो
navappabhedaṃ	नवप्पभेदं
navaṅgāni	नवङ्गानि
navaṅgānīti	नवङ्गानीति
navuti	नवुति
navutihatthubbedhaṃ	नवुतिहत्थुब्बेधं
navutikoṭimabodhayi	नवुतिकोटिमबोधयि
navutikoṭisahassāni	नवुतिकोटिसहस्सानि
navutikoṭisaṅkhyāya	नवुतिकोटिसङ्ख्याय
navutikoṭiyo	नवुतिकोटियो
navutivassasahassāni	नवुतिवस्ससहस्सानि
navutivassasahassānīti	नवुतिवस्ससहस्सानीति
navutiyeva	नवुतियेव
nayadānaṃ	नयदानं
nayamukhaṃ	नयमुखं
nayasahassena	नयसहस्सेन
nayasatasahassena	नयसतसहस्सेन
nayasatena	नयसतेन
nayasāgaro	नयसागरो
nayato	नयतो
nayaṃ	नयं
nayehi	नयेहि
nayena	नयेन
nayo	नयो
nayā	नया
nayānaṃ	नयानं
naṃ	नं
naṅguṭṭhe	नङ्गुट्ठे
naṭṭhepi	नट्ठेपि
ne	ने
nekakoṭisataṃ	नेककोटिसतं
nekkhamagavesako	नेक्खमगवेसको
nekkhammapāramitā	नेक्खम्मपारमिता
nekkhammapāramitāya	नेक्खम्मपारमिताय
nekkhammapāramiṃ	नेक्खम्मपारमिं
nekkhammapāramīti	नेक्खम्मपारमीति
nekkhammaṃ	नेक्खम्मं
nerañjaramupehiti	नेरञ्जरमुपेहिति
nerañjarāya	नेरञ्जराय
nesaṃ	नेसं
neva	नेव
ni	नि
nibaddhajagganabhāvo	निबद्धजग्गनभावो
nibbanti	निब्बन्ति
nibbattesi	निब्बत्तेसि
nibbattetvā	निब्बत्तेत्वा
nibbatti	निब्बत्ति
nibbattiṃsu	निब्बत्तिंसु
nibbattā	निब्बत्ता
nibbhayabhāvo	निब्भयभावो
nibbinnahadayo	निब्बिन्नहदयो
nibbutapadaṃ	निब्बुतपदं
nibbutapiṇḍabhuñjanabhāvo	निब्बुतपिण्डभुञ्जनभावो
nibbutiṃ	निब्बुतिं
nibbuto	निब्बुतो
nibbutā	निब्बुता
nibbānaṃ	निब्बानं
nibbāyi	निब्बायि
niccakālaṃ	निच्चकालं
niccalabhāvakaraṇatthaṃ	निच्चलभावकरणत्थं
niccalāva	निच्चलाव
niccameva	निच्चमेव
niccaṃ	निच्चं
nicchandarāgabhāvo	निच्छन्दरागभावो
nicchārento	निच्छारेन्तो
nicchāretvā	निच्छारेत्वा
nidahitvā	निदहित्वा
niddhantasuvaṇṇapiṇḍi	निद्धन्तसुवण्णपिण्डि
niddiṭṭhaṃ	निद्दिट्ठं
niddosaṃ	निद्दोसं
niddāvasena	निद्दावसेन
niddāyantena	निद्दायन्तेन
nidānakathā	निदानकथा
nidānakiccaṃ	निदानकिच्चं
nidānakosallatthaṃ	निदानकोसल्लत्थं
nidānassa	निदानस्स
nidānaṃ	निदानं
nidānāni	निदानानि
nigaccheyya	निगच्छेय्य
niggacchati	निग्गच्छति
niggahaṃ	निग्गहं
niggahaṃpe	निग्गहंपे
niggahito	निग्गहितो
niggāthakaṃ	निग्गाथकं
nigrodharukkho	निग्रोधरुक्खो
nijjhānaṃ	निज्झानं
nikhilena	निखिलेन
nikkhamantassa	निक्खमन्तस्स
nikkhamanti	निक्खमन्ति
nikkhamantūti	निक्खमन्तूति
nikkhamathāti	निक्खमथाति
nikkhamitvā	निक्खमित्वा
nikkhamiṃsu	निक्खमिंसु
nikkhantasayanassa	निक्खन्तसयनस्स
nikkhantaudakadhārā	निक्खन्तउदकधारा
nikkhantaṃ	निक्खन्तं
nikkhanto	निक्खन्तो
nikkhantosmi	निक्खन्तोस्मि
nikkhantā	निक्खन्ता
nikkhepakaṇḍeyeva	निक्खेपकण्डेयेव
nikkheparāsi	निक्खेपरासि
nikkhepaṃ	निक्खेपं
nikkhepo	निक्खेपो
nikkhepoti	निक्खेपोति
nikkhipitvā	निक्खिपित्वा
nikkhittaṃ	निक्खित्तं
nikāyabhāve	निकायभावे
nikāyato	निकायतो
nikāye	निकाये
nikāyo	निकायो
nikāyoti	निकायोति
nikāyā	निकाया
nikāyāti	निकायाति
nimantessāmīti	निमन्तेस्सामीति
nimantetvā	निमन्तेत्वा
nimantitā	निमन्तिता
nimantiyamāno	निमन्तियमानो
nimimahārājakāle	निमिमहाराजकाले
nimittaggāhamattakeneva	निमित्तग्गाहमत्तकेनेव
nimittaṃ	निमित्तं
nimitte	निमित्ते
nimminitvā	निम्मिनित्वा
nimmitabuddhassa	निम्मितबुद्धस्स
nimmitabuddhaṃ	निम्मितबुद्धं
nimmānaratī	निम्मानरती
ninnetā	निन्नेता
nipajjahaṃ	निपज्जहं
nipannassa	निपन्नस्स
nipannena	निपन्नेन
nipanno	निपन्नो
nippadesato	निप्पदेसतो
nippadesatova	निप्पदेसतोव
nippadesena	निप्पदेसेन
nipphannaṃ	निप्फन्नं
nipuṇaṃ	निपुणं
nipuṇāmalabuddhinā	निपुणामलबुद्धिना
nirantaraṃ	निरन्तरं
niravasesato	निरवसेसतो
nirayā	निरया
nirodhasaccaṃ	निरोधसच्चं
nirodhasamāpattisamāpannaṃ	निरोधसमापत्तिसमापन्नं
nirodhā	निरोधा
nirupabhogabhāvo	निरुपभोगभावो
nirākulā	निराकुला
nisabho	निसभो
nisajjaṭṭhānacaṅkame	निसज्जट्ठानचङ्कमे
nisinnasattāhaṃ	निसिन्नसत्ताहं
nisinnena	निसिन्नेन
nisinno	निसिन्नो
nisinnā	निसिन्ना
nissaddā	निस्सद्दा
nissandena	निस्सन्देन
nissaraṇatthā	निस्सरणत्था
nissayapaccayo	निस्सयपच्चयो
nissaṅgatāya	निस्सङ्गताय
nissesaṃ	निस्सेसं
nissāya	निस्साय
nisāmetha	निसामेथ
nisīdanamaṇḍapaṃ	निसीदनमण्डपं
nisīdanatthāya	निसीदनत्थाय
nisīdanaṭṭhānatthāya	निसीदनट्ठानत्थाय
nisīdanaṭṭhānaṃ	निसीदनट्ठानं
nisīdati	निसीदति
nisīdi	निसीदि
nisīditvā	निसीदित्वा
nisīdiṃsu	निसीदिंसु
nisīdāpetvā	निसीदापेत्वा
nivatta	निवत्त
nivatthapārutaṃ	निवत्थपारुतं
nivattitvā	निवत्तित्वा
nivesesi	निवेसेसि
nivāsanapārupanatthāya	निवासनपारुपनत्थाय
nivāsanānurūpaṃ	निवासनानुरूपं
nivāsaphāsukaṃ	निवासफासुकं
nivāsato	निवासतो
nivāsesi	निवासेसि
nivāsesiṃ	निवासेसिं
nivāsetvā	निवासेत्वा
niyatā	नियता
niyyātetvā	निय्यातेत्वा
niṭṭhitā	निट्ठिता
niṭṭhubhanādīhi	निट्ठुभनादीहि
niṭṭhāpetvā	निट्ठापेत्वा
no	नो
nosuttanāmikā	नोसुत्तनामिका
nti	न्ति
ntipi	न्तिपि
nu	नु
nuddhaṃsati	नुद्धंसति
nupalabbhati	नुपलब्भति
nupapajjare	नुपपज्जरे
nuppajjanti	नुप्पज्जन्ति
nuppajji	नुप्पज्जि
nāddasaṃ	नाद्दसं
nāgabhavanā	नागभवना
nāgalatādantakaṭṭhaṃ	नागलतादन्तकट्ठं
nāgapunnāgaketakaṃ	नागपुन्नागकेतकं
nāgarukkho	नागरुक्खो
nāgarukkhova	नागरुक्खोव
nāgarājena	नागराजेन
nāgarājā	नागराजा
nāgasamālā	नागसमाला
nāgā	नागा
nāhaṃ	नाहं
nāhesunti	नाहेसुन्ति
nāhesuṃ	नाहेसुं
nāhosi	नाहोसि
nālaṃ	नालं
nāma	नाम
nāmahaṃ	नामहं
nāmapadeso	नामपदेसो
nāmapi	नामपि
nāmarūpaparicchedakathā	नामरूपपरिच्छेदकथा
nāmarūpaparicchedo	नामरूपपरिच्छेदो
nāmato	नामतो
nāmaṃ	नामं
nāmesa	नामेस
nāmetanti	नामेतन्ति
nāmupaṭṭhāko	नामुपट्ठाको
nāmāti	नामाति
nānappakārakosallatthaṃ	नानप्पकारकोसल्लत्थं
nānappakārato	नानप्पकारतो
nānattaṃ	नानत्तं
nānattābhāvā	नानत्ताभावा
nānubhonti	नानुभोन्ति
nānājanasamākulaṃ	नानाजनसमाकुलं
nānākuṇapapūritaṃ	नानाकुणपपूरितं
nānākuṇapasañcayaṃ	नानाकुणपसञ्चयं
nānāsamāpattīhi	नानासमापत्तीहि
nānāvirāgavaṇṇavisesasampanno	नानाविरागवण्णविसेससम्पन्नो
nāradakūṭamhi	नारदकूटम्हि
nārado	नारदो
nārī	नारी
nāsakkhi	नासक्खि
nāsakkhiṃsu	नासक्खिंसु
nātho	नाथो
nāvaṃ	नावं
nāvāya	नावाय
nāyaṃ	नायं
nāṭakānaṃ	नाटकानं
nīharaṇābhāvo	नीहरणाभावो
nīhārena	नीहारेन
nīlapeyyālaṃ	नीलपेय्यालं
nīlapītalohitodātamañjiṭṭhapabhassaravasena	नीलपीतलोहितोदातमञ्जिट्ठपभस्सरवसेन
nīlarasmiyo	नीलरस्मियो
nīlaṭṭhānehi	नीलट्ठानेहि
nīpaṃ	नीपं
nūna	नून
obhāsanasamatthaṃ	ओभासनसमत्थं
obhāsayamantalikkhanti	ओभासयमन्तलिक्खन्ति
odahitvā	ओदहित्वा
odātarasmiyo	ओदातरस्मियो
oghataraṇādīni	ओघतरणादीनि
ogāḷhassa	ओगाळ्हस्स
okiranti	ओकिरन्ति
okkamati	ओक्कमति
okkamītiādīnaṃ	ओक्कमीतिआदीनं
okkanti	ओक्कन्ति
okāsaṃ	ओकासं
olaggetvā	ओलग्गेत्वा
olambantā	ओलम्बन्ता
olambantūti	ओलम्बन्तूति
olambatūti	ओलम्बतूति
olambi	ओलम्बि
olambitvā	ओलम्बित्वा
olambiṃsu	ओलम्बिंसु
olokaneneva	ओलोकनेनेव
olokento	ओलोकेन्तो
olokesi	ओलोकेसि
oloketi	ओलोकेति
oloketvā	ओलोकेत्वा
omuñcanto	ओमुञ्चन्तो
orabhāge	ओरभागे
orimatīraṃ	ओरिमतीरं
oruyha	ओरुय्ह
osamī	ओसमी
osaranti	ओसरन्ति
osarantu	ओसरन्तु
otāretvā	ओतारेत्वा
ovadati	ओवदति
pa	प
pabbajantūti	पब्बजन्तूति
pabbaji	पब्बजि
pabbajissāmīti	पब्बजिस्सामीति
pabbajitaṃ	पब्बजितं
pabbajito	पब्बजितो
pabbajitukāmā	पब्बजितुकामा
pabbajitvā	पब्बजित्वा
pabbajitā	पब्बजिता
pabbajitānañhi	पब्बजितानञ्हि
pabbajitānaṃ	पब्बजितानं
pabbajiṃsu	पब्बजिंसु
pabbajjasuttādīnaṃ	पब्बज्जसुत्तादीनं
pabbajjā	पब्बज्जा
pabbajjāti	पब्बज्जाति
pabbajjāya	पब्बज्जाय
pabbate	पब्बते
pabbato	पब्बतो
pabbaṃ	पब्बं
pabbhāre	पब्भारे
pabbājento	पब्बाजेन्तो
pabhedavacanato	पभेदवचनतो
pabhedaṃ	पभेदं
pabhā	पभा
pabhāvatī	पभावती
pabhāvito	पभावितो
pabhāya	पभाय
pabujjhitvā	पबुज्झित्वा
paccanīyamhi	पच्चनीयम्हि
paccanīyepi	पच्चनीयेपि
paccanīyānulomamhi	पच्चनीयानुलोमम्हि
paccanīyānulome	पच्चनीयानुलोमे
paccanīyānulomepi	पच्चनीयानुलोमेपि
paccatthikā	पच्चत्थिका
paccatthikānaṃ	पच्चत्थिकानं
paccavekkhantassa	पच्चवेक्खन्तस्स
paccavekkhanto	पच्चवेक्खन्तो
paccavekkhantānaṃ	पच्चवेक्खन्तानं
paccayākārapadeso	पच्चयाकारपदेसो
paccayākāravaṭṭaṃ	पच्चयाकारवट्टं
paccayākāravibhaṅgo	पच्चयाकारविभङ्गो
paccayākāre	पच्चयाकारे
paccayākāro	पच्चयाकारो
paccayānaṃ	पच्चयानं
paccekaṃ	पच्चेकं
pacchimabuddhavacanaṃ	पच्छिमबुद्धवचनं
pacchimayāmāvasāne	पच्छिमयामावसाने
pacchimuttarāya	पच्छिमुत्तराय
pacchā	पच्छा
pacchājātapaccayo	पच्छाजातपच्चयो
pacchāpi	पच्छापि
pacurāparādhā	पचुरापराधा
padabhājanīyaṃ	पदभाजनीयं
padahitvā	पदहित्वा
padahitvāna	पदहित्वान
padahiṃ	पदहिं
padakkhiṇamakaṃsu	पदक्खिणमकंसु
padakkhiṇaṃ	पदक्खिणं
padanti	पदन्ति
padasahassāni	पदसहस्सानि
padavalañjaṃ	पदवलञ्जं
padesavihārasuttantavasena	पदेसविहारसुत्तन्तवसेन
padesavihārasuttantaṃ	पदेसविहारसुत्तन्तं
padesaṃ	पदेसं
padese	पदेसे
padesena	पदेसेन
padeso	पदेसो
padissanti	पदिस्सन्ति
padissare	पदिस्सरे
padissati	पदिस्सति
padumagabbhaṃ	पदुमगब्भं
padumaṃ	पदुमं
padumo	पदुमो
padumuttaro	पदुमुत्तरो
padumā	पदुमा
paggahitamano	पग्गहितमनो
paggayha	पग्गय्ह
paggaṇha	पग्गण्ह
paggharatīti	पग्घरतीति
paghaṭṭitā	पघट्टिता
pahotīti	पहोतीति
pahānaṃ	पहानं
pahānāni	पहानानि
pahāraṃ	पहारं
pahāya	पहाय
pahīnakileso	पहीनकिलेसो
pahīnaṃ	पहीनं
pahūtadhanadhaññavā	पहूतधनधञ्ञवा
pajahanto	पजहन्तो
pajahi	पजहि
pajahinti	पजहिन्ति
pajahitvā	पजहित्वा
pajahiṃ	पजहिं
pajānāti	पजानाति
pakampatha	पकम्पथ
pakampathāti	पकम्पथाति
pakampati	पकम्पति
pakaraṇaṃ	पकरणं
pakaraṇānaṃ	पकरणानं
pakaraṇāni	पकरणानि
pakittetvā	पकित्तेत्वा
pakkamadhusakkaracuṇṇasappīhi	पक्कमधुसक्करचुण्णसप्पीहि
pakkamati	पक्कमति
pakkamuṃ	पक्कमुं
pakkhalitvā	पक्खलित्वा
pakkhandiṃsu	पक्खन्दिंसु
pakkhipitvā	पक्खिपित्वा
pakāsayissāmi	पकासयिस्सामि
pakāsitaṃ	पकासितं
palibodhato	पलिबोधतो
pallaṅkasmiñhi	पल्लङ्कस्मिञ्हि
pallaṅkassa	पल्लङ्कस्स
pallaṅkavaramābhuje	पल्लङ्कवरमाभुजे
pallaṅkaṃ	पल्लङ्कं
pallaṅke	पल्लङ्के
pallaṅkā	पल्लङ्का
paluggaṃ	पलुग्गं
palālasakaṭe	पलालसकटे
palāyati	पलायति
pamoditaṃ	पमोदितं
pamodito	पमोदितो
pamokāse	पमोकासे
pamudito	पमुदितो
pamukhaṃ	पमुखं
pamādacāraṃ	पमादचारं
pamādamāgamma	पमादमागम्म
pamāṇaṃ	पमाणं
pana	पन
panassa	पनस्स
panesa	पनेस
panesā	पनेसा
panetaṃ	पनेतं
panete	पनेते
panettha	पनेत्थ
panidaṃ	पनिदं
pannarasappabhedo	पन्नरसप्पभेदो
panāha	पनाह
papañcasaññāsaṅkhā	पपञ्चसञ्ञासङ्खा
papañco	पपञ्चो
paralokaṃ	परलोकं
paramatthabāhullato	परमत्थबाहुल्लतो
paramatthadesanā	परमत्थदेसना
paramatthakusalena	परमत्थकुसलेन
paramatthapāramī	परमत्थपारमी
paramattho	परमत्थो
paramāya	परमाय
paranimmitavasavattī	परनिम्मितवसवत्ती
parapaṭibaddhatāya	परपटिबद्धताय
paratīraṃ	परतीरं
paravāde	परवादे
paravādinā	परवादिना
paravādī	परवादी
paraṃ	परं
pari	परि
paribhaṇḍakatā	परिभण्डकता
paribhogaphāsukaṃ	परिभोगफासुकं
paribhogena	परिभोगेन
paribhuñjantassa	परिभुञ्जन्तस्स
paribhuñjitvā	परिभुञ्जित्वा
paribāhirāti	परिबाहिराति
pariccajituṃ	परिच्चजितुं
pariccajiṃ	परिच्चजिं
paricchedamattakameva	परिच्छेदमत्तकमेव
paricchede	परिच्छेदे
paricchedo	परिच्छेदो
paricchinne	परिच्छिन्ने
paricchinno	परिच्छिन्नो
paricchinnā	परिच्छिन्ना
paricchinnāpi	परिच्छिन्नापि
paridahitvā	परिदहित्वा
paridīpanā	परिदीपना
paridīpaye	परिदीपये
paridīpayeti	परिदीपयेति
paridīpitadhammakkhandhavasena	परिदीपितधम्मक्खन्धवसेन
pariggahakaraṇabhāvo	परिग्गहकरणभावो
parihariyamāno	परिहरियमानो
parikkhipanto	परिक्खिपन्तो
parikkhāre	परिक्खारे
parimoceti	परिमोचेति
parimuttiyā	परिमुत्तिया
parimāṇaṃ	परिमाणं
parinibbutassa	परिनिब्बुतस्स
parinibbute	परिनिब्बुते
parinibbānasamaye	परिनिब्बानसमये
parinibbānato	परिनिब्बानतो
paripucchaṃ	परिपुच्छं
paripācito	परिपाचितो
paripīḷito	परिपीळितो
paripūraya	परिपूरय
paripūrento	परिपूरेन्तो
paripūressantīti	परिपूरेस्सन्तीति
parirakkhati	परिरक्खति
pariruddho	परिरुद्धो
parisapariyante	परिसपरियन्ते
parisaṃ	परिसं
parisuddho	परिसुद्धो
parisā	परिसा
parisāya	परिसाय
parivattento	परिवत्तेन्तो
parivesane	परिवेसने
parivisituṃ	परिविसितुं
parivisiṃsu	परिविसिंसु
parivitakko	परिवितक्को
parivārayiṃsu	परिवारयिंसु
parivārenti	परिवारेन्ति
parivārito	परिवारितो
parivārā	परिवारा
parivārāti	परिवाराति
pariyattibbhājanatthato	परियत्तिब्भाजनत्थतो
pariyattibhedo	परियत्तिभेदो
pariyattibhājanatthato	परियत्तिभाजनत्थतो
pariyattibhāvato	परियत्तिभावतो
pariyattiyo	परियत्तियो
pariyesantassa	परियेसन्तस्स
pariyesissāmi	परियेसिस्सामि
pariyesitvā	परियेसित्वा
pariyonaddhā	परियोनद्धा
pariyuṭṭhānapaṭipakkhattā	परियुट्ठानपटिपक्खत्ता
pariyuṭṭhānappahānaṃ	परियुट्ठानप्पहानं
pariyāpannā	परियापन्ना
pariyāpuṇanti	परियापुणन्ति
pariyāpuṇassu	परियापुणस्सु
pariyāpuṇissasīti	परियापुणिस्ससीति
pariyāpuṇituṃ	परियापुणितुं
pariyāpuṇitvā	परियापुणित्वा
pariyāpuṇāti	परियापुणाति
pariyāpuṭā	परियापुटा
pariññātakkhandho	परिञ्ञातक्खन्धो
pasannacitto	पसन्नचित्तो
pasavatīti	पसवतीति
passa	पस्स
passantasseva	पस्सन्तस्सेव
passanti	पस्सन्ति
passati	पस्सति
passatīti	पस्सतीति
passaṃ	पस्सं
passesu	पस्सेसु
passeyya	पस्सेय्य
passi	पस्सि
pasādabahulānaṃ	पसादबहुलानं
pasādeti	पसादेति
pasādetvā	पसादेत्वा
pasāretvā	पसारेत्वा
pasāritarajatapaṭṭasumanapupphasantharasadiso	पसारितरजतपट्टसुमनपुप्फसन्थरसदिसो
pasīdi	पसीदि
pasīditvā	पसीदित्वा
patati	पतति
pathavikampane	पथविकम्पने
pathaviṃ	पथविं
pathavī	पथवी
pathe	पथे
patitāsu	पतितासु
patiṭṭhaha	पतिट्ठह
patiṭṭhāsi	पतिट्ठासि
patiṭṭhāya	पतिट्ठाय
pattacīvaramādāya	पत्तचीवरमादाय
pattaggahaṇaṃ	पत्तग्गहणं
pattaṃ	पत्तं
patte	पत्ते
patthanaṃ	पत्थनं
pattharitvāna	पत्थरित्वान
patthitaṃ	पत्थितं
patto	पत्तो
pattumicchasi	पत्तुमिच्छसि
pattuṇṇacīnapaṭakoseyyakambaladukulāni	पत्तुण्णचीनपटकोसेय्यकम्बलदुकुलानि
pattāni	पत्तानि
patvā	पत्वा
patvāte	पत्वाते
patīti	पतीति
pavanaṃ	पवनं
pavane	पवने
pavassanti	पवस्सन्ति
pavattanasamatthaṃ	पवत्तनसमत्थं
pavattaphalabhojano	पवत्तफलभोजनो
pavattaphalamādiyiṃ	पवत्तफलमादियिं
pavattaya	पवत्तय
pavattayuṃ	पवत्तयुं
pavattento	पवत्तेन्तो
pavattesuṃ	पवत्तेसुं
pavattetvā	पवत्तेत्वा
pavattinoti	पवत्तिनोति
pavattitadesanā	पवत्तितदेसना
pavattittha	पवत्तित्थ
pavattā	पवत्ता
pavecchati	पवेच्छति
pavedayiṃ	पवेदयिं
pavesetvā	पवेसेत्वा
paveṇipālanatthāya	पवेणिपालनत्थाय
pavisanto	पविसन्तो
pavisissāmīti	पविसिस्सामीति
pavisitvā	पविसित्वा
pavivekagate	पविवेकगते
pavivekakkhamaṃ	पविवेकक्खमं
pavivekamanubrūhetuṃ	पविवेकमनुब्रूहेतुं
pavivekañhi	पविवेकञ्हि
paviṭṭhakālo	पविट्ठकालो
paviṭṭhena	पविट्ठेन
paviṭṭho	पविट्ठो
pavuccati	पवुच्चति
pavuccatīti	पवुच्चतीति
pavāheti	पवाहेति
pavāhetvā	पवाहेत्वा
pavāresi	पवारेसि
pavāyati	पवायति
pavāḷamayā	पवाळमया
pavāḷatthambhesu	पवाळत्थम्भेसु
pavāḷavaṇṇaṃ	पवाळवण्णं
payirudāhāsi	पयिरुदाहासि
payirupāsamāno	पयिरुपासमानो
pañca	पञ्च
pañcacattālīsa	पञ्चचत्तालीस
pañcadasa	पञ्चदस
pañcadasappabhedā	पञ्चदसप्पभेदा
pañcadasavaggasaṅgahāni	पञ्चदसवग्गसङ्गहानि
pañcadosavivajjitanti	पञ्चदोसविवज्जितन्ति
pañcadosavivajjitaṃ	पञ्चदोसविवज्जितं
pañcakkhandhe	पञ्चक्खन्धे
pañcakkhandhā	पञ्चक्खन्धा
pañcakānaṃ	पञ्चकानं
pañcamattabhāṇavāro	पञ्चमत्तभाणवारो
pañcamaṃ	पञ्चमं
pañcamo	पञ्चमो
pañcannaṃ	पञ्चन्नं
pañcappabhedaṃ	पञ्चप्पभेदं
pañcasatasahassakahāpaṇāni	पञ्चसतसहस्सकहापणानि
pañcasatikasaṅgītikāle	पञ्चसतिकसङ्गीतिकाले
pañcasu	पञ्चसु
pañcatiṃsamattabhāṇavāraṃ	पञ्चतिंसमत्तभाणवारं
pañcavaggiyānaṃ	पञ्चवग्गियानं
pañcavassasahassaparimāṇakālaṃ	पञ्चवस्ससहस्सपरिमाणकालं
pañcavaṇṇāya	पञ्चवण्णाय
pañcavidhapātimokkhuddesapārājikādisattaāpattikkhandhamātikāvibhaṅgādippabhedā	पञ्चविधपातिमोक्खुद्देसपाराजिकादिसत्तआपत्तिक्खन्धमातिकाविभङ्गादिप्पभेदा
pañcaṅgikasseva	पञ्चङ्गिकस्सेव
pañcime	पञ्चिमे
pañcābhiññāsu	पञ्चाभिञ्ञासु
pañcāti	पञ्चाति
pañhapucchakaṃ	पञ्हपुच्छकं
pañhaṃ	पञ्हं
pañhesu	पञ्हेसु
pañhākammaṃ	पञ्हाकम्मं
pañhāpucchanaṃ	पञ्हापुच्छनं
pañhāvārā	पञ्हावारा
pañjalikā	पञ्जलिका
pañjalī	पञ्जली
paññatti	पञ्ञत्ति
paññattipathānurūpaṃ	पञ्ञत्तिपथानुरूपं
paññattīsu	पञ्ञत्तीसु
paññā	पञ्ञा
paññāpāramitā	पञ्ञापारमिता
paññāpāramitāya	पञ्ञापारमिताय
paññāpāramiṃ	पञ्ञापारमिं
paññāpāramīti	पञ्ञापारमीति
paññāsampadaṃ	पञ्ञासम्पदं
paññāsaṃ	पञ्ञासं
paññāsādhikāni	पञ्ञासाधिकानि
paññāya	पञ्ञाय
paññāyati	पञ्ञायति
paññāyatīti	पञ्ञायतीति
paññāyittha	पञ्ञायित्थ
paṇḍavapabbatapabbhāre	पण्डवपब्बतपब्भारे
paṇḍita	पण्डित
paṇḍito	पण्डितो
paṇḍitāti	पण्डिताति
paṇḍukambalanāmake	पण्डुकम्बलनामके
paṇḍukambalasilāsanassa	पण्डुकम्बलसिलासनस्स
paṇḍukambalasilāyaṃ	पण्डुकम्बलसिलायं
paṇṇacchadanaṃ	पण्णच्छदनं
paṇṇacchannā	पण्णच्छन्ना
paṇṇasālaka	पण्णसालक
paṇṇasālakanti	पण्णसालकन्ति
paṇṇasālakaṃ	पण्णसालकं
paṇṇasālakuṭidvāraṃ	पण्णसालकुटिद्वारं
paṇṇasālato	पण्णसालतो
paṇṇasālaṃ	पण्णसालं
paṇṇasālā	पण्णसाला
paṇṇasālāya	पण्णसालाय
paṇṇasālāyaṃ	पण्णसालायं
paṇṇāsa	पण्णास
paṇṇāsahatthubbedhaṃ	पण्णासहत्थुब्बेधं
paṇṇāsasaṅgahādianekavidhaṃ	पण्णाससङ्गहादिअनेकविधं
paṭhamabuddhavacanaṃ	पठमबुद्धवचनं
paṭhamasannipāte	पठमसन्निपाते
paṭhamasannipātoyeva	पठमसन्निपातोयेव
paṭhamataraṃ	पठमतरं
paṭhamayāme	पठमयामे
paṭhamaṃ	पठमं
paṭhame	पठमे
paṭhamo	पठमो
paṭhamābhisambuddho	पठमाभिसम्बुद्धो
paṭibāhati	पटिबाहति
paṭibāhento	पटिबाहेन्तो
paṭiggahito	पटिग्गहितो
paṭiggaho	पटिग्गहो
paṭighaṃ	पटिघं
paṭihaññatīti	पटिहञ्ञतीति
paṭijaggissāmi	पटिजग्गिस्सामि
paṭijaggitvā	पटिजग्गित्वा
paṭikkamanti	पटिक्कमन्ति
paṭikkamantītiādīsu	पटिक्कमन्तीतिआदीसु
paṭikkhipitvā	पटिक्खिपित्वा
paṭikkhittesu	पटिक्खित्तेसु
paṭilaggitaṃ	पटिलग्गितं
paṭilome	पटिलोमे
paṭimuñcitvā	पटिमुञ्चित्वा
paṭinivatteti	पटिनिवत्तेति
paṭipajji	पटिपज्जि
paṭipajjāhīti	पटिपज्जाहीति
paṭiparivattitvā	पटिपरिवत्तित्वा
paṭipuccheyyātha	पटिपुच्छेय्याथ
paṭipāṭi	पटिपाटि
paṭisambhidā	पटिसम्भिदा
paṭisambhidāhi	पटिसम्भिदाहि
paṭisambhidāppattassa	पटिसम्भिदाप्पत्तस्स
paṭisambhidāvibhaṅgo	पटिसम्भिदाविभङ्गो
paṭisandhiṃ	पटिसन्धिं
paṭisevato	पटिसेवतो
paṭititthaṃ	पटितित्थं
paṭivasati	पटिवसति
paṭivedho	पटिवेधो
paṭividdhadhammaṃ	पटिविद्धधम्मं
paṭividdhanti	पटिविद्धन्ति
paṭividdhoti	पटिविद्धोति
paṭividdhākuppo	पटिविद्धाकुप्पो
paṭivijjhanti	पटिविज्झन्ति
paṭivijjhantoyeva	पटिविज्झन्तोयेव
paṭivijjhi	पटिविज्झि
paṭivijjhitabbo	पटिविज्झितब्बो
paṭivijjhitvā	पटिविज्झित्वा
paṭiññaṃ	पटिञ्ञं
paṭṭhā	पट्ठा
paṭṭhānavaraṃ	पट्ठानवरं
paṭṭhānaṃ	पट्ठानं
paṭṭhānāni	पट्ठानानि
paṭṭhānānīti	पट्ठानानीति
paṭṭhāya	पट्ठाय
pe	पे
pesetvā	पेसेत्वा
phaggunī	फग्गुनी
phalabhārā	फलभारा
phalamuttame	फलमुत्तमे
phalaṃ	फलं
phalitā	फलिता
phalāphalaṃ	फलाफलं
pharasunā	फरसुना
pharati	फरति
phareyyuṃ	फरेय्युं
pharitvā	फरित्वा
phariṃsu	फरिंसु
phassapaccayā	फस्सपच्चया
phoṭā	फोटा
phusa	फुस
phussadevo	फुस्सदेवो
phusso	फुस्सो
phussā	फुस्सा
phuṭaṃ	फुटं
phāsukaṭṭhānaṃ	फासुकट्ठानं
phāsukā	फासुका
phāsuvihāraṃ	फासुविहारं
phītaṃ	फीतं
pipphalīti	पिप्फलीति
pitito	पितितो
pitu	पितु
pitucchādhītāya	पितुच्छाधीताय
pitupitāmahādayo	पितुपितामहादयो
pitā	पिता
pivatha	पिवथ
piyadassī	पियदस्सी
piyajālī	पियजाली
piyapālo	पियपालो
piyaṃ	पियं
piyaṅgurukkho	पियङ्गुरुक्खो
piṇḍapātaṃ	पिण्डपातं
piṇḍāya	पिण्डाय
piṭakanti	पिटकन्ति
piṭakasaddena	पिटकसद्देन
piṭakasampadānenātiādīsu	पिटकसम्पदानेनातिआदीसु
piṭakato	पिटकतो
piṭakatthavidū	पिटकत्थविदू
piṭakañca	पिटकञ्च
piṭakañcāti	पिटकञ्चाति
piṭakaṃ	पिटकं
piṭakesu	पिटकेसु
piṭakāni	पिटकानि
potthake	पोत्थके
poṇikanikāyo	पोणिकनिकायो
pubbacaritaṃ	पुब्बचरितं
pubbacariyakaṃ	पुब्बचरियकं
pubbakaṃ	पुब्बकं
pubbanimittesu	पुब्बनिमित्तेसु
pubbapatthanāvasena	पुब्बपत्थनावसेन
pubbayogo	पुब्बयोगो
pubbe	पुब्बे
pubbenivāsañāṇaṃ	पुब्बेनिवासञाणं
pucchanti	पुच्छन्ति
pucchati	पुच्छति
pucchatīti	पुच्छतीति
pucchi	पुच्छि
pucchitakāle	पुच्छितकाले
pucchitamattakeneva	पुच्छितमत्तकेनेव
pucchitapañhañca	पुच्छितपञ्हञ्च
pucchitasuttantā	पुच्छितसुत्तन्ता
pucchiṃsu	पुच्छिंसु
puggalapaññatti	पुग्गलपञ्ञत्ति
puggalapaññattiṃ	पुग्गलपञ्ञत्तिं
puggalapaññattīti	पुग्गलपञ्ञत्तीति
puggalavāre	पुग्गलवारे
puggalo	पुग्गलो
puggalā	पुग्गला
puna	पुन
punabbhavo	पुनब्भवो
punadivase	पुनदिवसे
punapi	पुनपि
punappunaṃ	पुनप्पुनं
punnāgapupphasantharasadisaṃ	पुन्नागपुप्फसन्थरसदिसं
punāpi	पुनापि
pupphadāmaṃ	पुप्फदामं
pupphanti	पुप्फन्ति
pupphasu	पुप्फसु
pupphavitānaṃ	पुप्फवितानं
pupphaṃ	पुप्फं
pupphehi	पुप्फेहि
pupphino	पुप्फिनो
pupphito	पुप्फितो
pupphitā	पुप्फिता
pupphitānaṃ	पुप्फितानं
pupphā	पुप्फा
pupphāni	पुप्फानि
pupphūpagaphalūpagarukkhasañchannaṃ	पुप्फूपगफलूपगरुक्खसञ्छन्नं
purato	पुरतो
purejātapaccayo	पुरेजातपच्चयो
purimā	पुरिमा
purisaṃ	पुरिसं
purisena	पुरिसेन
puriso	पुरिसो
purisuttame	पुरिसुत्तमे
purā	पुरा
puthujjanakalyāṇā	पुथुज्जनकल्याणा
puttaketi	पुत्तकेति
puttasinehassa	पुत्तसिनेहस्स
puññakamminaṃ	पुञ्ञकम्मिनं
puññakoṭṭhāsaṃ	पुञ्ञकोट्ठासं
puññāni	पुञ्ञानि
puññānubhāvena	पुञ्ञानुभावेन
puṇḍarīkarukkho	पुण्डरीकरुक्खो
puṇṇacandasassirīkaṃ	पुण्णचन्दसस्सिरीकं
puṇṇamano	पुण्णमनो
puṭṭhā	पुट्ठा
pāci	पाचि
pācīnadisābhimukho	पाचीनदिसाभिमुखो
pādamuddhari	पादमुद्धरि
pāde	पादे
pādesu	पादेसु
pādā	पादा
pākaṭaṃ	पाकटं
pākaṭo	पाकटो
pākaṭā	पाकटा
pākaṭāpe	पाकटापे
pālito	पालितो
pāmojjena	पामोज्जेन
pānīyaghaṭapānīyasaṅkhapānīyasarāvāni	पानीयघटपानीयसङ्खपानीयसरावानि
pāpakaṃ	पापकं
pāpake	पापके
pāpaṃ	पापं
pāpe	पापे
pāpetuṃ	पापेतुं
pāpetvā	पापेत्वा
pāpuṇi	पापुणि
pāpuṇinti	पापुणिन्ति
pāpuṇissasi	पापुणिस्ससि
pāpuṇissatīti	पापुणिस्सतीति
pāpuṇitvā	पापुणित्वा
pāpuṇāti	पापुणाति
pāpuṇātīti	पापुणातीति
pāragū	पारगू
pāramiyo	पारमियो
pāramiṃ	पारमिं
pāraṅgato	पारङ्गतो
pāricchattakamūle	पारिच्छत्तकमूले
pārichattakaṃ	पारिछत्तकं
pārupitvā	पारुपित्वा
pāsādesu	पासादेसु
pāsādiko	पासादिको
pātimokkhāni	पातिमोक्खानि
pāto	पातो
pātova	पातोव
pātubhavanti	पातुभवन्ति
pāturahesuṃ	पातुरहेसुं
pāturahosi	पातुरहोसि
pāvacanaṃ	पावचनं
pāvisi	पाविसि
pāvisī	पाविसी
pāyesi	पायेसि
pāyāsaṃ	पायासं
pāḷiyā	पाळिया
pāṇe	पाणे
pāṇā	पाणा
pāṭalirukkho	पाटलिरुक्खो
pāṭiyaputtasamāgame	पाटियपुत्तसमागमे
pītarasmiyo	पीतरस्मियो
pītaṭṭhānehi	पीतट्ठानेहि
pīti	पीति
pītisomanassajāto	पीतिसोमनस्सजातो
pītisomanassaṃ	पीतिसोमनस्सं
pītisukheneva	पीतिसुखेनेव
pītiyā	पीतिया
pītiṃ	पीतिं
pītiṃavijahitvā	पीतिंअविजहित्वा
pīḷetvā	पीळेत्वा
pīḷitaṃ	पीळितं
pūjamakāsi	पूजमकासि
pūjesi	पूजेसि
pūjetvā	पूजेत्वा
pūjite	पूजिते
pūjitā	पूजिता
pūjitāpi	पूजितापि
pūjārahāti	पूजारहाति
pūrayuṃ	पूरयुं
pūrehi	पूरेहि
pūrentassa	पूरेन्तस्स
pūrenti	पूरेन्ति
pūrento	पूरेन्तो
pūresi	पूरेसि
pūretvā	पूरेत्वा
pūritapāramibhāvaṃ	पूरितपारमिभावं
pūritattabhāvānaṃ	पूरितत्तभावानं
pūritaṃ	पूरितं
pūrāpetvā	पूरापेत्वा
pūtikāyaṃ	पूतिकायं
rajataghaṭehi	रजतघटेहि
rajatamayesu	रजतमयेसु
rajatamayā	रजतमया
rajatavaṇṇā	रजतवण्णा
rajitabbo	रजितब्बो
rajjasiriṃ	रज्जसिरिं
rajjaṃ	रज्जं
rajjena	रज्जेन
rajomalaṃ	रजोमलं
rakkhantaṃ	रक्खन्तं
rakkhati	रक्खति
rakkhatīti	रक्खतीति
ramaṇīyaṃ	रमणीयं
rammavatī	रम्मवती
rammā	रम्मा
ramāmi	रमामि
rasmiyo	रस्मियो
rasmiādīsu	रस्मिआदीसु
rasmīsu	रस्मीसु
ratanagharanti	रतनघरन्ति
ratanagharasattāhe	रतनघरसत्ताहे
ratanagharaṃ	रतनघरं
ratanaghare	रतनघरे
ratanamattaanucaṅkamaṃ	रतनमत्तअनुचङ्कमं
ratanamattamakulaṃ	रतनमत्तमकुलं
ratanattaye	रतनत्तये
ratanehi	रतनेहि
ratanike	रतनिके
ratanā	रतना
ratanāvaliṃ	रतनावलिं
rattakambalaparikkhittā	रत्तकम्बलपरिक्खित्ता
rattavākacīraṃ	रत्तवाकचीरं
rattaṅkurarukkho	रत्तङ्कुररुक्खो
rattaṭṭhānehi	रत्तट्ठानेहि
rattikkhaye	रत्तिक्खये
rattindivaparicchedaṃ	रत्तिन्दिवपरिच्छेदं
rattindivaparicchedo	रत्तिन्दिवपरिच्छेदो
rattindivāni	रत्तिन्दिवानि
rattiyo	रत्तियो
rattāvasesena	रत्तावसेसेन
ravanakasakuṇānañca	रवनकसकुणानञ्च
ravati	रवति
rañño	रञ्ञो
raṭṭhapīḷanakilesābhāvo	रट्ठपीळनकिलेसाभावो
raṭṭhaṃ	रट्ठं
raṭṭhuppādaṃ	रट्ठुप्पादं
revato	रेवतो
revatoti	रेवतोति
rittā	रित्ता
rogo	रोगो
ropissaṃ	रोपिस्सं
ropitaṃ	रोपितं
ruciṃ	रुचिं
rujjanti	रुज्जन्ति
rukkhamūlasenāsanassa	रुक्खमूलसेनासनस्स
rukkhamūlaṃ	रुक्खमूलं
rukkhe	रुक्खे
rukkhā	रुक्खा
rāgaṃ	रागं
rāgādipaṭipakkhabhūto	रागादिपटिपक्खभूतो
rāgānusayānanti	रागानुसयानन्ति
rāhulabhaddassa	राहुलभद्दस्स
rājagahaṃ	राजगहं
rājagahe	राजगहे
rājakulesu	राजकुलेसु
rājakumāresu	राजकुमारेसु
rājakumāro	राजकुमारो
rājarājamahāmaccehi	राजराजमहामच्चेहि
rājā	राजा
rāmā	रामा
rāsivaḍḍhako	रासिवड्ढको
rūpagataṃva	रूपगतंव
rūpakkhandho	रूपक्खन्धो
rūpavibhatti	रूपविभत्ति
rūpañca	रूपञ्च
rūpaṃ	रूपं
rūpārūpadhamme	रूपारूपधम्मे
rūpārūpaparicchedaṃ	रूपारूपपरिच्छेदं
rūpāvacarakusalato	रूपावचरकुसलतो
rūpūpapattiyā	रूपूपपत्तिया
sa	स
sabbabhave	सब्बभवे
sabbabhikkhūnaṃ	सब्बभिक्खूनं
sabbadassī	सब्बदस्सी
sabbadā	सब्बदा
sabbakammamupāgataṃ	सब्बकम्ममुपागतं
sabbakathāmaggesu	सब्बकथामग्गेसु
sabbakilese	सब्बकिलेसे
sabbakālaṃ	सब्बकालं
sabbakāmo	सब्बकामो
sabbamitto	सब्बमित्तो
sabbampetaṃ	सब्बम्पेतं
sabbampi	सब्बम्पि
sabbanāmā	सब्बनामा
sabbapāramīti	सब्बपारमीति
sabbasattānaṃ	सब्बसत्तानं
sabbasaṅkhārāti	सब्बसङ्खाराति
sabbaso	सब्बसो
sabbasāmayikaparisāya	सब्बसामयिकपरिसाय
sabbattha	सब्बत्थ
sabbaññubuddhena	सब्बञ्ञुबुद्धेन
sabbaññubuddhānaṃyeva	सब्बञ्ञुबुद्धानंयेव
sabbaññubuddhāva	सब्बञ्ञुबुद्धाव
sabbaññutaññāṇaṃ	सब्बञ्ञुतञ्ञाणं
sabbaññutaññāṇena	सब्बञ्ञुतञ्ञाणेन
sabbaññutaññāṇeneva	सब्बञ्ञुतञ्ञाणेनेव
sabbaññutaṃ	सब्बञ्ञुतं
sabbaṃ	सब्बं
sabbaṅgasampannaṃ	सब्बङ्गसम्पन्नं
sabbaṅgasampannā	सब्बङ्गसम्पन्ना
sabbe	सब्बे
sabbehipi	सब्बेहिपि
sabbepi	सब्बेपि
sabbesaṃ	सब्बेसं
sabbesu	सब्बेसु
sabbeva	सब्बेव
sabbā	सब्बा
sabbāni	सब्बानि
sabhiyo	सभियो
sabhāvaparicchinnattā	सभावपरिच्छिन्नत्ता
sabhāvarasalakkhaṇe	सभावरसलक्खणे
saccamanurakkhantassa	सच्चमनुरक्खन्तस्स
saccapadeso	सच्चपदेसो
saccapaññatti	सच्चपञ्ञत्ति
saccapāramitā	सच्चपारमिता
saccapāramiṃ	सच्चपारमिं
saccapāramīti	सच्चपारमीति
saccavibhaṅgo	सच्चविभङ्गो
saccayamakaṃ	सच्चयमकं
saccesu	सच्चेसु
sacchikatanirodho	सच्छिकतनिरोधो
sacchikatenidha	सच्छिकतेनिध
saccikaṭṭhaparamatthenāti	सच्चिकट्ठपरमत्थेनाति
saccikaṭṭho	सच्चिकट्ठो
saccāni	सच्चानि
sace	सचे
sacīvaraṃ	सचीवरं
saddehi	सद्देहि
saddhammaṃ	सद्धम्मं
saddhammo	सद्धम्मो
saddhivihārikānaṃ	सद्धिविहारिकानं
saddhiṃ	सद्धिं
saddhāsampannānaṃ	सद्धासम्पन्नानं
saddārammaṇaṃ	सद्दारम्मणं
sadevakaṃ	सदेवकं
sadevake	सदेवके
sadevakā	सदेवका
sadhamme	सधम्मे
sadā	सदा
saggesu	सग्गेसु
saggā	सग्गा
sagāthakaṃ	सगाथकं
sagāthāvaggo	सगाथावग्गो
saha	सह
sahadhammikaṃ	सहधम्मिकं
sahajātapaccayo	सहजातपच्चयो
sahampatibrahmunā	सहम्पतिब्रह्मुना
sahassabhāgena	सहस्सभागेन
sahassavaṭṭiyo	सहस्सवट्टियो
sahassāni	सहस्सानि
sahati	सहति
sahatthā	सहत्था
sahaṃ	सहं
sahetudhammaṃ	सहेतुधम्मं
sahetusambhavaṃ	सहेतुसम्भवं
sajjhāyantānaṃ	सज्झायन्तानं
sajjitaṃ	सज्जितं
sakalampetaṃ	सकलम्पेतं
sakalampi	सकलम्पि
sakalarattiṃ	सकलरत्तिं
sakalasarīraṃ	सकलसरीरं
sakalaṃ	सकलं
sakalopi	सकलोपि
sakalāyapi	सकलायपि
sakassamā	सकस्समा
sakattānaṃ	सकत्तानं
sakavāde	सकवादे
sakaṭṭhāneva	सकट्ठानेव
sakhilā	सखिला
sakhuraṃ	सखुरं
sakkaccaṃ	सक्कच्चं
sakkadattiyaṃ	सक्कदत्तियं
sakkassa	सक्कस्स
sakkena	सक्केन
sakkhissathāti	सक्खिस्सथाति
sakko	सक्को
sakkomi	सक्कोमि
sakkoti	सक्कोति
sakkotīti	सक्कोतीति
sakkā	सक्का
sakkāti	सक्काति
sakyarājakule	सक्यराजकुले
sakāsayā	सकासया
salakkhaṇasaṅkhāto	सलक्खणसङ्खातो
salakkhaṇā	सलक्खणा
salakkhaṇāpi	सलक्खणापि
salalarukkho	सललरुक्खो
salalaṃ	सललं
sallahukabhāvo	सल्लहुकभावो
sallakkhesi	सल्लक्खेसि
sallakkhetvā	सल्लक्खेत्वा
samabhavīti	समभवीति
samanantarapaccayo	समनन्तरपच्चयो
samannāgataṃ	समन्नागतं
samannāgato	समन्नागतो
samantapaṭṭhānassa	समन्तपट्ठानस्स
samantapaṭṭhāne	समन्तपट्ठाने
samantato	समन्ततो
samantā	समन्ता
samanupassāmi	समनुपस्सामि
samatalaṃ	समतलं
samatalo	समतलो
samavippakiṇṇavālukaṃ	समविप्पकिण्णवालुकं
samayaṃ	समयं
samaye	समये
samayena	समयेन
samaṃ	समं
samaṅgo	समङ्गो
samaṇadhammaṃ	समणधम्मं
samaṇasukhehi	समणसुखेहि
samaṇasukhāni	समणसुखानि
sambalo	सम्बलो
sambhavo	सम्भवो
sambodhiṃ	सम्बोधिं
sambuddhassa	सम्बुद्धस्स
sambuddhā	सम्बुद्धा
sameti	समेति
samijjhatīti	समिज्झतीति
samiṃsu	समिंसु
sammappadhāna	सम्मप्पधान
sammappadhānavibhaṅgo	सम्मप्पधानविभङ्गो
sammappadhānāni	सम्मप्पधानानि
sammasanaṃ	सम्मसनं
sammasantassa	सम्मसन्तस्स
sammasantassāpi	सम्मसन्तस्सापि
sammasati	सम्मसति
sammasato	सम्मसतो
sammasi	सम्मसि
sammasitadhammo	सम्मसितधम्मो
sammasitaṭṭhānaṃ	सम्मसितट्ठानं
sammaṭṭhampi	सम्मट्ठम्पि
sammukhā	सम्मुखा
sammā	सम्मा
sammānāvamānakkhamo	सम्मानावमानक्खमो
sammāsambuddhassa	सम्मासम्बुद्धस्स
sammāsambuddhaṃ	सम्मासम्बुद्धं
sammāsambuddhe	सम्मासम्बुद्धे
sammāsambuddho	सम्मासम्बुद्धो
samo	समो
samodhānetvā	समोधानेत्वा
sampajjati	सम्पज्जति
sampajāno	सम्पजानो
sampakampi	सम्पकम्पि
sampasāritamecakapaṭaṃ	सम्पसारितमेचकपटं
sampasāritarajatapaṭṭavitānā	सम्पसारितरजतपट्टविताना
sampattagāme	सम्पत्तगामे
sampattaparisāya	सम्पत्तपरिसाय
sampattiṃ	सम्पत्तिं
sampattānaṃ	सम्पत्तानं
sampavattayi	सम्पवत्तयि
sampavedhi	सम्पवेधि
sampayogo	सम्पयोगो
sampayuttapaccayo	सम्पयुत्तपच्चयो
sampayuttaṃ	सम्पयुत्तं
sampayuttena	सम्पयुत्तेन
sampaṭicchitvā	सम्पटिच्छित्वा
sampuṇṇo	सम्पुण्णो
sampādethāti	सम्पादेथाति
sampāpuṇeyya	सम्पापुणेय्य
sampāpuṇāti	सम्पापुणाति
samudayasaccaṃ	समुदयसच्चं
samuddā	समुद्दा
samudācarante	समुदाचरन्ते
samudācaranti	समुदाचरन्ति
samudācārena	समुदाचारेन
samussitasuvaṇṇakkhandho	समुस्सितसुवण्णक्खन्धो
samussitesu	समुस्सितेसु
samussāhitamānaso	समुस्साहितमानसो
samā	समा
samācikkhi	समाचिक्खि
samādhisampadaṃ	समाधिसम्पदं
samādhissa	समाधिस्स
samādiya	समादिय
samāgamma	समागम्म
samāgamo	समागमो
samāgantvā	समागन्त्वा
samāhitā	समाहिता
samālā	समाला
samānakathā	समानकथा
samānaṃ	समानं
samānenti	समानेन्ति
samānetabbaṃ	समानेतब्बं
samāpattiyo	समापत्तियो
samāpattīnañca	समापत्तीनञ्च
samāpattīsu	समापत्तीसु
samāruyha	समारुय्ह
samāsaṃ	समासं
samūhato	समूहतो
sandanti	सन्दन्ति
sandeho	सन्देहो
sandhāvissaṃ	सन्धाविस्सं
sandhāya	सन्धाय
sandissamānaṃ	सन्दिस्समानं
sandissati	सन्दिस्सति
sannipatitesu	सन्निपतितेसु
sannisinno	सन्निसिन्नो
santacittā	सन्तचित्ता
santakaṃ	सन्तकं
santakāti	सन्तकाति
sante	सन्ते
santhambhetīti	सन्थम्भेतीति
santharitvā	सन्थरित्वा
santikaṃ	सन्तिकं
santike	सन्तिके
santikenidānanti	सन्तिकेनिदानन्ति
santikenidānaṃ	सन्तिकेनिदानं
santo	सन्तो
santusito	सन्तुसितो
santuṭṭhā	सन्तुट्ठा
santāressaṃ	सन्तारेस्सं
santāretvā	सन्तारेत्वा
sapattacīvaraṃ	सपत्तचीवरं
sappaṃ	सप्पं
sappinavanītatelamadhuphāṇitānaṃ	सप्पिनवनीततेलमधुफाणितानं
sappissa	सप्पिस्स
sappurisā	सप्पुरिसा
sappītikabhāvo	सप्पीतिकभावो
saputtadāro	सपुत्तदारो
sarakutti	सरकुत्ति
saraṇadukā	सरणदुका
saraṇamakaṃsu	सरणमकंसु
saraṇaṃ	सरणं
saraṇesu	सरणेसु
saraṇo	सरणो
saraṇā	सरणा
sare	सरे
saresu	सरेसु
saro	सरो
sarīrappabhā	सरीरप्पभा
sarīrappadesā	सरीरप्पदेसा
sarīrassa	सरीरस्स
sarīrato	सरीरतो
sarīraṃ	सरीरं
sarīre	सरीरे
sarīresu	सरीरेसु
sarīrobhāso	सरीरोभासो
sasapaṇḍitajātakāle	ससपण्डितजातकाले
sasaṅghaṃ	ससङ्घं
sasaṅghe	ससङ्घे
sassamiva	सस्समिव
sasādīhi	ससादीहि
sasāvako	ससावको
satabhāgena	सतभागेन
satakoṭiyo	सतकोटियो
satasahassabhāgena	सतसहस्सभागेन
satasahassagghanikaṃ	सतसहस्सग्घनिकं
satasahassagghanikā	सतसहस्सग्घनिका
satasahassakappamatthake	सतसहस्सकप्पमत्थके
satasahasse	सतसहस्से
satasahassehi	सतसहस्सेहि
satasahassepi	सतसहस्सेपि
satasahassāni	सतसहस्सानि
sataṃ	सतं
sati	सति
satipaṭṭhānapadeso	सतिपट्ठानपदेसो
satipaṭṭhānavibhaṅgo	सतिपट्ठानविभङ्गो
satipaṭṭhāne	सतिपट्ठाने
satipaṭṭhānā	सतिपट्ठाना
sato	सतो
satta	सत्त
sattahi	सत्तहि
sattahivassasahassāni	सत्तहिवस्ससहस्सानि
sattakkhattuṃ	सत्तक्खत्तुं
sattamaṃ	सत्तमं
sattamo	सत्तमो
sattamā	सत्तमा
sattannaṃ	सत्तन्नं
sattapaññāsañca	सत्तपञ्ञासञ्च
sattappakaraṇauggahaṇañca	सत्तप्पकरणउग्गहणञ्च
sattappakaraṇāni	सत्तप्पकरणानि
sattaratanakhacitaṃ	सत्तरतनखचितं
sattaratanamayaṃ	सत्तरतनमयं
sattaratanamayesu	सत्तरतनमयेसु
sattaratanamayo	सत्तरतनमयो
sattaratanamayāva	सत्तरतनमयाव
sattaratanapaṭimaṇḍitaṃ	सत्तरतनपटिमण्डितं
sattati	सत्तति
sattatihatthubbedhaṃ	सत्ततिहत्थुब्बेधं
sattatikappasahassāni	सत्ततिकप्पसहस्सानि
sattesu	सत्तेसु
satthu	सत्थु
satthuno	सत्थुनो
satthā	सत्था
satthāradassanaṃ	सत्थारदस्सनं
satthāraṃ	सत्थारं
satthārā	सत्थारा
satthāti	सत्थाति
sattihi	सत्तिहि
sattubhastajātake	सत्तुभस्तजातके
sattā	सत्ता
sattāhabbhantareyeva	सत्ताहब्भन्तरेयेव
sattāhaccayena	सत्ताहच्चयेन
sattāhaṃ	सत्ताहं
sattāhe	सत्ताहे
sattāhāni	सत्ताहानि
sattānaṃ	सत्तानं
sattāti	सत्ताति
satā	सता
savanatotha	सवनतोथ
savantiyo	सवन्तियो
sayambhūñāṇādhigamena	सयम्भूञाणाधिगमेन
sayaṃvasī	सयंवसी
sañcarittapeyyālaṃ	सञ्चरित्तपेय्यालं
sañjātappamodā	सञ्जातप्पमोदा
sañjātasaṃvego	सञ्जातसंवेगो
sañjīvo	सञ्जीवो
saññino	सञ्ञिनो
saññāpesi	सञ्ञापेसि
saññāpetvā	सञ्ञापेत्वा
saṃ	सं
saṃharitvā	संहरित्वा
saṃsandiyamānaṃ	संसन्दियमानं
saṃsuddhagahaṇiko	संसुद्धगहणिको
saṃsādenti	संसादेन्ति
saṃsārasāgaro	संसारसागरो
saṃsāravaṭṭaṃ	संसारवट्टं
saṃsāroti	संसारोति
saṃvarāsaṃvaradiṭṭhiviniveṭhananāmarūpaparicchedakathāti	संवरासंवरदिट्ठिविनिवेठननामरूपपरिच्छेदकथाति
saṃvarāsaṃvarakathā	संवरासंवरकथा
saṃvarāsaṃvaro	संवरासंवरो
saṃvarāsaṃvaroti	संवरासंवरोति
saṃvattanti	संवत्तन्ति
saṃvattati	संवत्तति
saṃvaṇṇitā	संवण्णिता
saṃvegajātāhi	संवेगजाताहि
saṃvidhāya	संविधाय
saṃviggamānaso	संविग्गमानसो
saṃvijjamānā	संविज्जमाना
saṃyuttaaṅguttarikadvemahānikāyappamāṇāva	संयुत्तअङ्गुत्तरिकद्वेमहानिकायप्पमाणाव
saṃyuttanikāye	संयुत्तनिकाये
saṃyuttanikāyo	संयुत्तनिकायो
saṃyuttasaṅgaho	संयुत्तसङ्गहो
saṅgahappabhedaṃ	सङ्गहप्पभेदं
saṅgahitaṃ	सङ्गहितं
saṅgahitena	सङ्गहितेन
saṅgahitā	सङ्गहिता
saṅgahitāni	सङ्गहितानि
saṅgaho	सङ्गहो
saṅgayhamānaṃ	सङ्गय्हमानं
saṅghassa	सङ्घस्स
saṅghaṃ	सङ्घं
saṅghe	सङ्घे
saṅghārāmaṃ	सङ्घारामं
saṅgāyantena	सङ्गायन्तेन
saṅgītaṃ	सङ्गीतं
saṅgīte	सङ्गीते
saṅgītiāropitanayena	सङ्गीतिआरोपितनयेन
saṅgīto	सङ्गीतो
saṅkamitvā	सङ्कमित्वा
saṅkamitvāva	सङ्कमित्वाव
saṅkampi	सङ्कम्पि
saṅkhabrāhmaṇakāle	सङ्खब्राह्मणकाले
saṅkhapālajātakāle	सङ्खपालजातकाले
saṅkhepo	सङ्खेपो
saṅkhyaṃ	सङ्ख्यं
saṅkhyā	सङ्ख्या
saṅkhārayamakaṃ	सङ्खारयमकं
saṅkhārā	सङ्खारा
saṇhasukhumadhammaṃ	सण्हसुखुमधम्मं
saṇikaṃ	सणिकं
saṇṭhahatīti	सण्ठहतीति
saṭṭhi	सट्ठि
saṭṭhibhikkhusatasahassāni	सट्ठिभिक्खुसतसहस्सानि
saṭṭhihatthaṃ	सट्ठिहत्थं
saṭṭhihatthe	सट्ठिहत्थे
saṭṭhihatthubbedhaṃ	सट्ठिहत्थुब्बेधं
saṭṭhivassasahassāni	सट्ठिवस्ससहस्सानि
saṭṭhivassasahassānīti	सट्ठिवस्ससहस्सानीति
saṭṭhivassikattherā	सट्ठिवस्सिकत्थेरा
sedā	सेदा
sekhā	सेखा
sekkhā	सेक्खा
selamayaṃ	सेलमयं
selo	सेलो
selā	सेला
senakapaṇḍitakāle	सेनकपण्डितकाले
senānigame	सेनानिगमे
senāsanaṃ	सेनासनं
serī	सेरी
sesi	सेसि
sesānampi	सेसानम्पि
setabhittiyo	सेतभित्तियो
setaṭṭhānehi	सेतट्ठानेहि
sevanti	सेवन्ति
seyyathāpi	सेय्यथापि
seyyaṃ	सेय्यं
sibbitabbābhāvo	सिब्बितब्बाभावो
siddhatthassa	सिद्धत्थस्स
siddhattho	सिद्धत्थो
siddhippattassa	सिद्धिप्पत्तस्स
siggavo	सिग्गवो
sikhī	सिखी
sikkhanti	सिक्खन्ति
sikkhantī	सिक्खन्ती
sikkhitasikkhā	सिक्खितसिक्खा
sikkhā	सिक्खा
sikkhāpadapaññāpanaṃ	सिक्खापदपञ्ञापनं
sikkhāpadavibhaṅge	सिक्खापदविभङ्गे
sikkhāpadavibhaṅgo	सिक्खापदविभङ्गो
sikkhāpadāni	सिक्खापदानि
sikkāya	सिक्काय
siliṭṭhaṃ	सिलिट्ठं
sineruṃ	सिनेरुं
siniddhāhāro	सिनिद्धाहारो
sirasmiṃ	सिरस्मिं
sirimā	सिरिमा
sirisayane	सिरिसयने
siriyā	सिरिया
sirīmato	सिरीमतो
sissehi	सिस्सेहि
sissānusissasaṅkhātāya	सिस्सानुसिस्ससङ्खाताय
sissānusissehīti	सिस्सानुसिस्सेहीति
sivamañjase	सिवमञ्जसे
sive	सिवे
sivijātake	सिविजातके
sivirājakāle	सिविराजकाले
siyā	सिया
so	सो
sobhati	सोभति
sobhavatī	सोभवती
sobhaṇaṃ	सोभणं
sobhesi	सोभेसि
sobheyyāti	सोभेय्याति
sobhito	सोभितो
sodhayissāmi	सोधयिस्सामि
sodhemahaṃ	सोधेमहं
sodhenti	सोधेन्ति
sodhetha	सोधेथ
sodhetuṃ	सोधेतुं
sodhīyati	सोधीयति
soko	सोको
somanassakumārakāle	सोमनस्सकुमारकाले
somanassaṃ	सोमनस्सं
sopi	सोपि
sosetvā	सोसेत्वा
sotthijo	सोत्थिजो
sotthiyena	सोत्थियेन
sotthiṃ	सोत्थिं
sotukāmaṃ	सोतुकामं
sotūnaṃ	सोतूनं
sovaṇṇamayaṃ	सोवण्णमयं
soḷasa	सोळस
soṇako	सोणको
soṇarukkho	सोणरुक्खो
soṇo	सोणो
soṇā	सोणा
su	सु
subhaddo	सुभद्दो
subhaddā	सुभद्दा
sucimpi	सुचिम्पि
suciṃ	सुचिं
suciṇṇe	सुचिण्णे
suciṇṇo	सुचिण्णो
sudassananagare	सुदस्सननगरे
sudassanasiluccaye	सुदस्सनसिलुच्चये
sudassanaṃ	सुदस्सनं
sudassano	सुदस्सनो
sudassanā	सुदस्सना
sudatto	सुदत्तो
sudattā	सुदत्ता
suddhagocarā	सुद्धगोचरा
suddhikagāthā	सुद्धिकगाथा
suddhodano	सुद्धोदनो
suddhāvāse	सुद्धावासे
sudevo	सुदेवो
sudhammaṃ	सुधम्मं
sudhammo	सुधम्मो
sudhammā	सुधम्मा
sudhaññavatī	सुधञ्ञवती
sudinnaṃ	सुदिन्नं
sudinno	सुदिन्नो
sudubbudhaṃ	सुदुब्बुधं
sugambhīrāti	सुगम्भीराति
suggahitā	सुग्गहिता
suguttaṃ	सुगुत्तं
sujāto	सुजातो
sujātā	सुजाता
sujātāya	सुजाताय
sukathitaṃ	सुकथितं
sukato	सुकतो
sukhadukkhaṃ	सुखदुक्खं
sukhadukkhe	सुखदुक्खे
sukhamāvahāti	सुखमावहाति
sukhaṃ	सुखं
sukhena	सुखेन
sukhito	सुखितो
sukhumālakaraṇabhāvo	सुखुमालकरणभावो
sukhāya	सुखाय
sukhī	सुखी
sulabhatāya	सुलभताय
sumanadevatthero	सुमनदेवत्थेरो
sumano	सुमनो
sumanā	सुमना
sumaṅgalaṃ	सुमङ्गलं
sumedhakathā	सुमेधकथा
sumedhapaṇḍitena	सुमेधपण्डितेन
sumedhapaṇḍito	सुमेधपण्डितो
sumedho	सुमेधो
sumitto	सुमित्तो
sumāpitā	सुमापिता
sunando	सुनन्दो
sunandā	सुनन्दा
sundaraṃ	सुन्दरं
sundarī	सुन्दरी
sunetto	सुनेत्तो
supaccakkho	सुपच्चक्खो
supakkalākhārasasiñcamānā	सुपक्कलाखारससिञ्चमाना
suparicchinno	सुपरिच्छिन्नो
suphassā	सुफस्सा
suphusitaṃ	सुफुसितं
suppatiṭṭhito	सुप्पतिट्ठितो
suppatīto	सुप्पतीतो
suppaṭipanno	सुप्पटिपन्नो
supupphitasatapattasassirikaṃ	सुपुप्फितसतपत्तसस्सिरिकं
surakkhito	सुरक्खितो
surattadupaṭṭaṃ	सुरत्तदुपट्टं
suruci	सुरुचि
surāmā	सुरामा
susīmo	सुसीमो
sutta	सुत्त
suttanipāte	सुत्तनिपाते
suttantabhājanīyaabhidhammabhājanīyapañhapucchakanayānaṃ	सुत्तन्तभाजनीयअभिधम्मभाजनीयपञ्हपुच्छकनयानं
suttantabhājanīyaabhidhammabhājanīyapañhapucchakānaṃ	सुत्तन्तभाजनीयअभिधम्मभाजनीयपञ्हपुच्छकानं
suttantabhājanīyaṃ	सुत्तन्तभाजनीयं
suttantapiṭakaṃ	सुत्तन्तपिटकं
suttantapiṭake	सुत्तन्तपिटके
suttantañca	सुत्तन्तञ्च
suttantaṃ	सुत्तन्तं
suttanti	सुत्तन्ति
suttantikadukā	सुत्तन्तिकदुका
suttantā	सुत्तन्ता
suttanāmakaṃ	सुत्तनामकं
suttapadānañceva	सुत्तपदानञ्चेव
suttasabhāgato	सुत्तसभागतो
suttasahassaṃ	सुत्तसहस्सं
suttasahassesu	सुत्तसहस्सेसु
suttasahassāni	सुत्तसहस्सानि
suttasatāni	सुत्तसतानि
suttaṃ	सुत्तं
suttaṃpe	सुत्तंपे
suttena	सुत्तेन
suttesu	सुत्तेसु
suttādīni	सुत्तादीनि
suttānaṃ	सुत्तानं
suttāni	सुत्तानि
sutvā	सुत्वा
sutvāna	सुत्वान
suvavatthito	सुववत्थितो
suvaṇṇakalasehi	सुवण्णकलसेहि
suvaṇṇamayesu	सुवण्णमयेसु
suvaṇṇamayā	सुवण्णमया
suvaṇṇapaṭa	सुवण्णपट
suvaṇṇapaṭapasāritā	सुवण्णपटपसारिता
suvaṇṇapaṭimā	सुवण्णपटिमा
suvaṇṇapādukañca	सुवण्णपादुकञ्च
suvaṇṇapātiṃ	सुवण्णपातिं
suvaṇṇarajatamaṇimuttādipūrite	सुवण्णरजतमणिमुत्तादिपूरिते
suvaṇṇarasadhārābhisiñcamānā	सुवण्णरसधाराभिसिञ्चमाना
suvaṇṇavaṇṇaṃ	सुवण्णवण्णं
suvaṇṇāliṅgasadisaṃ	सुवण्णालिङ्गसदिसं
suvaṇṇāliṅgaṃ	सुवण्णालिङ्गं
suvisodhitaṃ	सुविसोधितं
suvuttato	सुवुत्ततो
suññā	सुञ्ञा
sve	स्वे
svāhaṃ	स्वाहं
svātanāya	स्वातनाय
sā	सा
sādhakāni	साधकानि
sādhentā	साधेन्ता
sādhu	साधु
sādhukāraṃ	साधुकारं
sādhāraṇabhāvo	साधारणभावो
sādhāraṇatāya	साधारणताय
sādhūti	साधूति
sāgaresu	सागरेसु
sāgaro	सागरो
sāgarā	सागरा
sākhāpalāsasadisā	साखापलाससदिसा
sālakalyāṇī	सालकल्याणी
sālarukkho	सालरुक्खो
sālarājāva	सालराजाव
sālo	सालो
sālāpi	सालापि
sāmaññaṃ	सामञ्ञं
sāmikā	सामिका
sāmukkaṃsikena	सामुक्कंसिकेन
sāmā	सामा
sāragavesīti	सारगवेसीति
sārarukkho	साररुक्खो
sārasūciṃ	सारसूचिं
sāratthiko	सारत्थिको
sāriputta	सारिपुत्त
sāriputtassa	सारिपुत्तस्स
sāriputtattherappabhavo	सारिपुत्तत्थेरप्पभवो
sāriputtattheravatthu	सारिपुत्तत्थेरवत्थु
sāriputtatthero	सारिपुत्तत्थेरो
sāriputtāti	सारिपुत्ताति
sāropamaṃ	सारोपमं
sāruppabhāvo	सारुप्पभावो
sāsanato	सासनतो
sāsanaṃ	सासनं
sāsane	सासने
sāsitāti	सासिताति
sātisāro	सातिसारो
sāvakabhāsitattā	सावकभासितत्ता
sāvakasannipātesu	सावकसन्निपातेसु
sāvakasannipāto	सावकसन्निपातो
sāvakasannipātā	सावकसन्निपाता
sāvako	सावको
sāvakā	सावका
sāvikā	साविका
sāvitoti	सावितोति
sāyanhasamayaṃ	सायन्हसमयं
sāyanhasamaye	सायन्हसमये
sāyaṃ	सायं
sāṭakasmiṃ	साटकस्मिं
sāṭakayugaṃ	साटकयुगं
sāṭakaṃ	साटकं
sāṭṭhakathānaṃ	साट्ठकथानं
sīhanādaṃ	सीहनादं
sīhassa	सीहस्स
sīhaṃ	सीहं
sīho	सीहो
sīlakkhandhādipāripūriṃyeva	सीलक्खन्धादिपारिपूरिंयेव
sīlapāramitā	सीलपारमिता
sīlapāramitāya	सीलपारमिताय
sīlapāramiṃ	सीलपारमिं
sīlapāramīti	सीलपारमीति
sīlasampadaṃ	सीलसम्पदं
sīlassa	सीलस्स
sīlavanāgarājakāle	सीलवनागराजकाले
sīlaṃ	सीलं
sīle	सीले
sīlesu	सीलेसु
sīlāni	सीलानि
sīsakahāpaṇādīni	सीसकहापणादीनि
sīsaṃ	सीसं
sīsenādāya	सीसेनादाय
sītalaṃ	सीतलं
sītena	सीतेन
sītuṇhapaṭighātena	सीतुण्हपटिघातेन
sīvalā	सीवला
sīvalī	सीवली
sūcanato	सूचनतो
sūceti	सूचेति
sūdanato	सूदनतो
sūriyappabhā	सूरियप्पभा
sūriye	सूरिये
sūriyo	सूरियो
sūriyuggamanaṃ	सूरियुग्गमनं
sūriyuggamane	सूरियुग्गमने
sūriyālokena	सूरियालोकेन
tacchakānaṃ	तच्छकानं
tadatthajotikā	तदत्थजोतिका
tadaṅgappahānaṃ	तदङ्गप्पहानं
tadupasammanti	तदुपसम्मन्ति
tadā	तदा
tadādakkhiṃ	तदादक्खिं
tadāti	तदाति
tamantarahitaṃ	तमन्तरहितं
tambapaṇṇinivāsinaṃ	तम्बपण्णिनिवासिनं
tamenaṃ	तमेनं
tamhā	तम्हा
tampi	तम्पि
tanti	तन्ति
tantiatthassa	तन्तिअत्थस्स
tantinayānugaṃ	तन्तिनयानुगं
tantiyo	तन्तियो
tantiyā	तन्तिया
tanu	तनु
tarantassa	तरन्तस्स
tarantā	तरन्ता
tasitā	तसिता
tasmiṃ	तस्मिं
tasmiṃyeva	तस्मिंयेव
tasmā	तस्मा
tassa	तस्स
tassaṃ	तस्सं
tasseva	तस्सेव
tassuddāna	तस्सुद्दान
tassupari	तस्सुपरि
tassā	तस्सा
tassāyevattho	तस्सायेवत्थो
tathā	तथा
tathāgatassa	तथागतस्स
tathāgatavacanaṃ	तथागतवचनं
tathāgataṃ	तथागतं
tathāgate	तथागते
tathāgato	तथागतो
tathāgatoti	तथागतोति
tathāhaṃ	तथाहं
tathārūpaṃ	तथारूपं
tathārūpo	तथारूपो
tatiyasaṅgītikālā	ततियसङ्गीतिकाला
tatiyaṃ	ततियं
tatiye	ततिये
tatiyo	ततियो
tatiyābhisamayo	ततियाभिसमयो
tato	ततो
tattakampi	तत्तकम्पि
tattha	तत्थ
tattheva	तत्थेव
tatthāsuṃ	तत्थासुं
tatthāti	तत्थाति
tava	तव
tavantike	तवन्तिके
tayo	तयो
tayopi	तयोपि
tayā	तया
tañcassa	तञ्चस्स
tañhi	तञ्हि
taḷākassa	तळाकस्स
taḷākaṃ	तळाकं
taṃ	तं
taṅkhaṇaññeva	तङ्खणञ्ञेव
taṇhādiṭṭhisaṃkilesānaṃ	तण्हादिट्ठिसंकिलेसानं
taṇhānaṃ	तण्हानं
taṇḍule	तण्डुले
te	ते
tehi	तेहि
tejasā	तेजसा
temāsaṃ	तेमासं
tena	तेन
teneva	तेनेव
tepajja	तेपज्ज
tepi	तेपि
tepiṭakassa	तेपिटकस्स
tesaṃ	तेसं
tesaṃyeva	तेसंयेव
tesu	तेसु
tesveva	तेस्वेव
thaddhavisamabhūmibhāgatā	थद्धविसमभूमिभागता
thaddhavisamatā	थद्धविसमता
thambhesu	थम्भेसु
thenetvā	थेनेत्वा
theragā	थेरगा
theragāthā	थेरगाथा
therassa	थेरस्स
therehi	थेरेहि
therena	थेरेन
thereneva	थेरेनेव
thero	थेरो
therova	थेरोव
therīgāthā	थेरीगाथा
thokaṃ	थोकं
thoke	थोके
thometvā	थोमेत्वा
thomitā	थोमिता
thutappasattho	थुतप्पसत्थो
thāmadassinā	थामदस्सिना
thāmappattaṃ	थामप्पत्तं
ti	ति
ticīvarehi	तिचीवरेहि
tidasālaye	तिदसालये
tidhā	तिधा
tidivakkamo	तिदिवक्कमो
tikacchedo	तिकच्छेदो
tikadukabhājanaṃ	तिकदुकभाजनं
tikadukapaṭṭhānaṃ	तिकदुकपट्ठानं
tikadukañca	तिकदुकञ्च
tikamātikā	तिकमातिका
tikapaṭṭhānaṃ	तिकपट्ठानं
tikatikapaṭṭhānaṃ	तिकतिकपट्ठानं
tike	तिके
tikesu	तिकेसु
tikesuyeva	तिकेसुयेव
tikicchake	तिकिच्छके
tikicchāpeti	तिकिच्छापेति
tikkhattuṃ	तिक्खत्तुं
tikā	तिका
timattabhāṇavāraṃ	तिमत्तभाणवारं
timattabhāṇavāro	तिमत्तभाणवारो
timirapiṅgalamahāmaccho	तिमिरपिङ्गलमहामच्छो
tipiṭakadharo	तिपिटकधरो
tippabhedameva	तिप्पभेदमेव
tiracchānagatā	तिरच्छानगता
tissabhūtitthero	तिस्सभूतित्थेरो
tisso	तिस्सो
tissā	तिस्सा
titthe	तित्थे
titthiyā	तित्थिया
titti	तित्ति
tivaggo	तिवग्गो
tividhaggi	तिविधग्गि
tividhena	तिविधेन
tividho	तिविधो
tiṃsabhikkhusahassāni	तिंसभिक्खुसहस्सानि
tiṃsahatthubbedhaṃ	तिंसहत्थुब्बेधं
tiṃsakappasahassamatthake	तिंसकप्पसहस्समत्थके
tiṃsavassasahassāni	तिंसवस्ससहस्सानि
tiṇhena	तिण्हेन
tiṇāni	तिणानि
tiṇṇampi	तिण्णम्पि
tiṇṇaṃ	तिण्णं
tiṇṇena	तिण्णेन
tiṭṭhamāno	तिट्ठमानो
tiṭṭhati	तिट्ठति
tosayanto	तोसयन्तो
tulābhūto	तुलाभूतो
tulābhūtā	तुलाभूता
tumhe	तुम्हे
tumhādise	तुम्हादिसे
tunnaṃ	तुन्नं
turiyehi	तुरियेहि
turiyā	तुरिया
tusitabhavane	तुसितभवने
tusitapurā	तुसितपुरा
tusite	तुसिते
tusitā	तुसिता
tuvaṃ	तुवं
tuyhaṃ	तुय्हं
tuṭṭhahaṭṭhaṃ	तुट्ठहट्ठं
tuṭṭhamānasā	तुट्ठमानसा
tuṭṭhi	तुट्ठि
tuṭṭhiñca	तुट्ठिञ्च
tuṭṭhiṃ	तुट्ठिं
tuṭṭho	तुट्ठो
tvampi	त्वम्पि
tvaṃ	त्वं
tā	ता
tādihi	तादिहि
tādisaṃ	तादिसं
tāni	तानि
tāpasapabbajjaṃ	तापसपब्बज्जं
tāpasapabbajjāya	तापसपब्बज्जाय
tāpasaparikkhāre	तापसपरिक्खारे
tāpasaṃ	तापसं
tāpaso	तापसो
tāpena	तापेन
tārakarūpappabhā	तारकरूपप्पभा
tārakarūpesu	तारकरूपेसु
tārakarūpāni	तारकरूपानि
tārakā	तारका
tārayanto	तारयन्तो
tārayati	तारयति
tāremi	तारेमि
tāresi	तारेसि
tāsañca	तासञ्च
tāsaṃ	तासं
tāsaṃyeva	तासंयेव
tāta	तात
tātāti	ताताति
tāva	ताव
tāvade	तावदे
tāvadeva	तावदेव
tāvatiṃsabhavane	तावतिंसभवने
tāvatiṃse	तावतिंसे
tāvatiṃsesu	तावतिंसेसु
tāvatiṃsānaṃ	तावतिंसानं
tāvimaṃ	ताविमं
tāya	ताय
tāyati	तायति
tīhi	तीहि
tīramhi	तीरम्हि
tīre	तीरे
tīsu	तीसु
tīṇi	तीणि
tīṇisatasahassāni	तीणिसतसहस्सानि
tūriyassa	तूरियस्स
ubbhijji	उब्भिज्जि
ubhato	उभतो
ubhatobyañjanapaṇḍakā	उभतोब्यञ्जनपण्डका
ubhatovibhaṅganiddesakhandhakaparivārā	उभतोविभङ्गनिद्देसखन्धकपरिवारा
ubhayanidānasampannassa	उभयनिदानसम्पन्नस्स
ubhayāni	उभयानि
ubho	उभो
ubhopete	उभोपेते
ubhosu	उभोसु
ucchuyantaṃva	उच्छुयन्तंव
uccāraṭṭhānamhi	उच्चारट्ठानम्हि
udagāhiniṃ	उदगाहिनिं
udakacāṭiyo	उदकचाटियो
udakapariyantaṃ	उदकपरियन्तं
udakassa	उदकस्स
udakañca	उदकञ्च
udakaṃ	उदकं
udapādi	उदपादि
udayo	उदयो
uddesamaggo	उद्देसमग्गो
uddesaṃ	उद्देसं
uddhanesu	उद्धनेसु
uddhaṃ	उद्धं
uddānasaṅgahavaggasaṅgahapeyyālasaṅgahaekanipātadukanipātādinipātasaṅgahasaṃyuttasaṅgaha	उद्दानसङ्गहवग्गसङ्गहपेय्यालसङ्गहएकनिपातदुकनिपातादिनिपातसङ्गहसंयुत्तसङ्गह
udeno	उदेनो
udumbararukkho	उदुम्बररुक्खो
udā	उदा
udāharaṇaṃ	उदाहरणं
udāharituṃ	उदाहरितुं
udāhu	उदाहु
udāna	उदान
udānaṃ	उदानं
udānesi	उदानेसि
uggahetvā	उग्गहेत्वा
uggahitanti	उग्गहितन्ति
uggahitaṃ	उग्गहितं
uggantvāpi	उग्गन्त्वापि
uggatejo	उग्गतेजो
uggato	उग्गतो
uggatāpanaṃ	उग्गतापनं
uggatāpano	उग्गतापनो
uggaṇhantopi	उग्गण्हन्तोपि
uggaṇhi	उग्गण्हि
uggaṇhitvā	उग्गण्हित्वा
uggiramānaṃ	उग्गिरमानं
ukkhaliyādīni	उक्खलियादीनि
ukkhepanīyakammatajjanīyakammāraho	उक्खेपनीयकम्मतज्जनीयकम्मारहो
ukkhipanti	उक्खिपन्ति
ummādassa	उम्मादस्स
umāpupphanīluppaladalasañchannaṃ	उमापुप्फनीलुप्पलदलसञ्छन्नं
unnāmetvā	उन्नामेत्वा
upaccagā	उपच्चगा
upacālā	उपचाला
upadduto	उपद्दुतो
upadhārento	उपधारेन्तो
upagamanamattameva	उपगमनमत्तमेव
upagantvāna	उपगन्त्वान
upagataṃ	उपगतं
upahāraṃ	उपहारं
upakaraṇesu	उपकरणेसु
upakena	उपकेन
upakārāya	उपकाराय
upalabbhati	उपलब्भति
upanidhāyahaṃ	उपनिधायहं
upanissayapaccayo	उपनिस्सयपच्चयो
upanissayaṃ	उपनिस्सयं
upaparikkhanti	उपपरिक्खन्ति
upapatti	उपपत्ति
upari	उपरि
upariniggatāhi	उपरिनिग्गताहि
uparitale	उपरितले
upasammati	उपसम्मति
upasampādento	उपसम्पादेन्तो
upasanto	उपसन्तो
upasaṅkamitvā	उपसङ्कमित्वा
upasaṅkamma	उपसङ्कम्म
upasobhati	उपसोभति
upasoṇā	उपसोणा
upasālo	उपसालो
upatisso	उपतिस्सो
upatissā	उपतिस्सा
upaṭṭhahanti	उपट्ठहन्ति
upaṭṭhissatimaṃ	उपट्ठिस्सतिमं
upaṭṭhāko	उपट्ठाको
upaṭṭhānaṃ	उपट्ठानं
upaṭṭhātiyeva	उपट्ठातियेव
upekkhanaṃ	उपेक्खनं
upekkhāpāramitā	उपेक्खापारमिता
upekkhāpāramiṃ	उपेक्खापारमिं
upetaṃ	उपेतं
uppajja	उप्पज्ज
uppajjanabhāvo	उप्पज्जनभावो
uppajjantāpi	उप्पज्जन्तापि
uppajjati	उप्पज्जति
uppajji	उप्पज्जि
uppajjitvā	उप्पज्जित्वा
uppalavaṇṇā	उप्पलवण्णा
uppannesu	उप्पन्नेसु
uppannoti	उप्पन्नोति
uppannā	उप्पन्ना
uppattiyā	उप्पत्तिया
uppādanatthāya	उप्पादनत्थाय
uppādentesupi	उप्पादेन्तेसुपि
uppādetuṃ	उप्पादेतुं
uppādetvā	उप्पादेत्वा
uppāṭetvā	उप्पाटेत्वा
upādinnakaphassādīsu	उपादिन्नकफस्सादीसु
upādinnakasarīraṃ	उपादिन्नकसरीरं
upādāya	उपादाय
upāgantvā	उपागन्त्वा
upāgatosmīti	उपागतोस्मीति
upārambhādihetu	उपारम्भादिहेतु
upārambhānisaṃsā	उपारम्भानिसंसा
upāyena	उपायेन
uragādike	उरगादिके
uruveḷā	उरुवेळा
ussāhajāto	उस्साहजातो
ussāhaṃ	उस्साहं
ussāhena	उस्साहेन
ussāpento	उस्सापेन्तो
usumaṃ	उसुमं
uttamapabbajjā	उत्तमपब्बज्जा
uttarakuruṃ	उत्तरकुरुं
uttaranti	उत्तरन्ति
uttaraṃ	उत्तरं
uttaripi	उत्तरिपि
uttaro	उत्तरो
uttarā	उत्तरा
uttarāsaṅgena	उत्तरासङ्गेन
uttasati	उत्तसति
uttiyo	उत्तियो
utuvasse	उतुवस्से
utuṃ	उतुं
utūnaṃ	उतूनं
uyyojesi	उय्योजेसि
uyyojetabbo	उय्योजेतब्बो
uyyānakīḷāya	उय्यानकीळाय
uyyānavimānakapparukkhesu	उय्यानविमानकप्परुक्खेसु
uyyānaṃ	उय्यानं
uṇhabhāvaṃ	उण्हभावं
uṇhañca	उण्हञ्च
uṇhaṃ	उण्हं
uṇhe	उण्हे
uṭṭhahanti	उट्ठहन्ति
uṭṭhahantūti	उट्ठहन्तूति
uṭṭhahatūti	उट्ठहतूति
uṭṭhahi	उट्ठहि
uṭṭhahiṃsu	उट्ठहिंसु
uṭṭhāpanīyabhāvo	उट्ठापनीयभावो
uṭṭhāpetvā	उट्ठापेत्वा
uṭṭhāyāsanā	उट्ठायासना
va	व
vacana	वचन
vacanamabrvi	वचनमब्र्वि
vacanatthakosallatthaṃ	वचनत्थकोसल्लत्थं
vacanattho	वचनत्थो
vacanaṃ	वचनं
vacanesu	वचनेसु
vaccaṃ	वच्चं
vacībhedaṃ	वचीभेदं
vadanti	वदन्ति
vadati	वदति
vadesīti	वदेसीति
vadeyya	वदेय्य
vadāmīti	वदामीति
vajjanti	वज्जन्ति
vajjayantā	वज्जयन्ता
vanasaṇḍe	वनसण्डे
vandissatīti	वन्दिस्सतीति
vandissāmīti	वन्दिस्सामीति
vanditvā	वन्दित्वा
vapayanti	वपयन्ति
varagandhañca	वरगन्धञ्च
varasamāpattiyo	वरसमापत्तियो
varasāṭakayugaṃ	वरसाटकयुगं
varuṇo	वरुणो
vasanaṭṭhānaṃ	वसनट्ठानं
vasantassa	वसन्तस्स
vasante	वसन्ते
vasantena	वसन्तेन
vasanto	वसन्तो
vasena	वसेन
vasi	वसि
vasitvā	वसित्वा
vassasahassaṃ	वस्ससहस्सं
vassasahassenapi	वस्ससहस्सेनपि
vassasahassānaṃ	वस्ससहस्सानं
vassasahassāni	वस्ससहस्सानि
vassasahassānīti	वस्ससहस्सानीति
vassasatasahassanti	वस्ससतसहस्सन्ति
vassasatasahassaṃ	वस्ससतसहस्सं
vassasatasahassenapi	वस्ससतसहस्सेनपि
vassasatasahassānaṃ	वस्ससतसहस्सानं
vassasataṃ	वस्ससतं
vassasatenapi	वस्ससतेनपि
vassasatānaṃ	वस्ससतानं
vassasatāni	वस्ससतानि
vassāni	वस्सानि
vasudhā	वसुधा
vasībhūtassa	वसीभूतस्स
vasīgaṇena	वसीगणेन
vasīhiṭṭhakathā	वसीहिट्ठकथा
vata	वत
vatamadhiṭṭhahinti	वतमधिट्ठहिन्ति
vataṃ	वतं
vattabbaṃ	वत्तब्बं
vattabbe	वत्तब्बे
vattabbo	वत्तब्बो
vattamānā	वत्तमाना
vattanti	वत्तन्ति
vattasampattiyā	वत्तसम्पत्तिया
vattati	वत्तति
vattaṃ	वत्तं
vatthu	वत्थु
vatthupi	वत्थुपि
vatthurūpaṃ	वत्थुरूपं
vatthāni	वत्थानि
vattā	वत्ता
vatvā	वत्वा
vavatthapetvāva	ववत्थपेत्वाव
vavatthāpitāya	ववत्थापिताय
vayadhammā	वयधम्मा
vaḍḍhakivaṇṇaṃ	वड्ढकिवण्णं
vaḍḍhati	वड्ढति
vaḍḍheti	वड्ढेति
vaḍḍhetvā	वड्ढेत्वा
vaḷañjanaṃ	वळञ्जनं
vaṃ	वं
vaṃsānurakkhaṇatthāya	वंसानुरक्खणत्थाय
vaṅkakājaṃ	वङ्ककाजं
vaṅkapabbatasadise	वङ्कपब्बतसदिसे
vaṇṇadhātu	वण्णधातु
vaṇṇapokkharatāya	वण्णपोक्खरताय
vaṇṇaṃ	वण्णं
vaṇṇenātiādīsu	वण्णेनातिआदीसु
vaṇṇitā	वण्णिता
vaṭumāyanaṃ	वटुमायनं
vaṭṭati	वट्टति
vaṭṭatīti	वट्टतीति
ve	वे
vebhārapabbate	वेभारपब्बते
vebhāraṃ	वेभारं
vedajāto	वेदजातो
vedalla	वेदल्ल
vedallanti	वेदल्लन्ति
vedallaṃ	वेदल्लं
vedanā	वेदना
vedanākkhandhavaseneva	वेदनाक्खन्धवसेनेव
vedanāpañcakaindriyavasena	वेदनापञ्चकइन्द्रियवसेन
vedanāsatipaṭṭhānavaseneva	वेदनासतिपट्ठानवसेनेव
vedanāttikavaseneva	वेदनात्तिकवसेनेव
vedanāvasena	वेदनावसेन
vedanāvaseneva	वेदनावसेनेव
vedañca	वेदञ्च
vedehamuninā	वेदेहमुनिना
veditabbaṃ	वेदितब्बं
veditabbo	वेदितब्बो
veditabbā	वेदितब्बा
vedāna	वेदान
vedānaṃ	वेदानं
vegena	वेगेन
vehapphale	वेहप्फले
vehāsaṃ	वेहासं
velante	वेलन्ते
velantena	वेलन्तेन
velāya	वेलाय
veneyyajjhāsayānulomena	वेनेय्यज्झासयानुलोमेन
vesaṃ	वेसं
vessabhū	वेस्सभू
vessantararājakāleti	वेस्सन्तरराजकालेति
vessantarasadise	वेस्सन्तरसदिसे
vessantarattabhāve	वेस्सन्तरत्तभावे
vessantarattabhāvā	वेस्सन्तरत्तभावा
vesārajjaññāṇaṃ	वेसारज्जञ्ञाणं
vevaṇṇiyaṃ	वेवण्णियं
veyyākaraṇa	वेय्याकरण
veyyākaraṇaṃ	वेय्याकरणं
veṭhāpetvā	वेठापेत्वा
vi	वि
vibha	विभ
vibhajanto	विभजन्तो
vibhajitvā	विभजित्वा
vibhattaṃ	विभत्तं
vibhattiyo	विभत्तियो
vibhatto	विभत्तो
vibhattā	विभत्ता
vibhavopi	विभवोपि
vibhaṅgappakaraṇaṃ	विभङ्गप्पकरणं
vibhaṅgā	विभङ्गा
vibhāvanā	विभावना
vibhāvaye	विभावये
vibhāvayeti	विभावयेति
vibhūsanaṭṭhānabhāvo	विभूसनट्ठानभावो
vibhūsanaṭṭhānābhāvo	विभूसनट्ठानाभावो
vicakkhaṇe	विचक्खणे
vicarantaṃ	विचरन्तं
vicaraṇaṃ	विचरणं
vicariṃsu	विचरिंसु
vicinanto	विचिनन्तो
vicinantohaṃ	विचिनन्तोहं
vicinissāmi	विचिनिस्सामि
vicinitvā	विचिनित्वा
vicintesiṃ	विचिन्तेसिं
vicināmi	विचिनामि
vicito	विचितो
vicittattharaṇavaṇṇo	विचित्तत्थरणवण्णो
viddhaṃsetvā	विद्धंसेत्वा
viddhaṃsiyanti	विद्धंसियन्ति
vidhamitvā	विधमित्वा
vidhurapaṇḍitakāle	विधुरपण्डितकाले
vidhuro	विधुरो
vidhāvati	विधावति
vigatapaccayo	विगतपच्चयो
vigatā	विगता
vighāsādo	विघासादो
vighātassa	विघातस्स
viharati	विहरति
viharatītiādinā	विहरतीतिआदिना
viharāmi	विहरामि
vihāraṃ	विहारं
vihārena	विहारेन
vihāsi	विहासि
vihāsinti	विहासिन्ति
vihāsīti	विहासीति
vijahatīti	विजहतीति
vijitaṃ	विजितं
vijitāvī	विजितावी
vijjamāne	विज्जमाने
vijjante	विज्जन्ते
vijjati	विज्जति
vijjhiyanto	विज्झियन्तो
vijjā	विज्जा
vijjābhāgino	विज्जाभागिनो
vijjāttayachaḷabhiññācatupaṭisambhidāppabhedaṃ	विज्जात्तयछळभिञ्ञाचतुपटिसम्भिदाप्पभेदं
vijjāyo	विज्जायो
vijānāma	विजानाम
vikiriyanti	विकिरियन्ति
vikkhambhanasamucchedappahānāni	विक्खम्भनसमुच्छेदप्पहानानि
vikkhambhetvā	विक्खम्भेत्वा
vikopeti	विकोपेति
viloketvā	विलोकेत्वा
vimalehi	विमलेहि
vimuccissatīti	विमुच्चिस्सतीति
vinassati	विनस्सति
vinassatu	विनस्सतु
vinayanato	विनयनतो
vinayapiṭakaṃ	विनयपिटकं
vinayapiṭake	विनयपिटके
vinayatantiṃ	विनयतन्तिं
vinayaṃ	विनयं
vinaye	विनये
vinayo	विनयो
vinayoti	विनयोति
vinayādayo	विनयादयो
vindituṃ	विन्दितुं
vineti	विनेति
vinetuṃ	विनेतुं
vinicchayaṃ	विनिच्छयं
vinivijjhitvā	विनिविज्झित्वा
vinodehi	विनोदेहि
vināyake	विनायके
vināyako	विनायको
vipajjati	विपज्जति
vipassanaṃ	विपस्सनं
vipassanā	विपस्सना
vipassanābalassa	विपस्सनाबलस्स
vipassanābalaṃ	विपस्सनाबलं
vipassī	विपस्सी
vipattiñcāpi	विपत्तिञ्चापि
vipattiṃ	विपत्तिं
vippakāraṃ	विप्पकारं
vippayogo	विप्पयोगो
vippayuttapaccayo	विप्पयुत्तपच्चयो
vippayuttaṃ	विप्पयुत्तं
vippayuttena	विप्पयुत्तेन
vipulo	विपुलो
vipulā	विपुला
vipākantaraṃ	विपाकन्तरं
vipākapaccayo	विपाकपच्चयो
vipākato	विपाकतो
virajjhissāma	विरज्झिस्साम
virajjhiya	विरज्झिय
viroca	विरोच
virocanti	विरोचन्ति
virocati	विरोचति
virocittha	विरोचित्थ
virocituṃ	विरोचितुं
virociṃsu	विरोचिंसु
visayhaseṭṭhikāle	विसय्हसेट्ठिकाले
visayo	विसयो
visayoti	विसयोति
visaṃvādeti	विसंवादेति
visaṃyuttā	विसंयुत्ता
visaṅkhataṃ	विसङ्खतं
visesabhūtā	विसेसभूता
visesanayattā	विसेसनयत्ता
visesavantataro	विसेसवन्ततरो
visesavaṇṇasaṇṭhānañca	विसेसवण्णसण्ठानञ्च
visesena	विसेसेन
vissajjanañca	विस्सज्जनञ्च
vissajjanaṃ	विस्सज्जनं
vissajjenti	विस्सज्जेन्ति
vissajjetvā	विस्सज्जेत्वा
vissakammadevaputtaṃ	विस्सकम्मदेवपुत्तं
vissakammadevaputte	विस्सकम्मदेवपुत्ते
vissakammanimmitaṃ	विस्सकम्मनिम्मितं
vissakammena	विस्सकम्मेन
visākhā	विसाखा
visākhāpuṇṇamadivase	विसाखापुण्णमदिवसे
visākhāpuṇṇamāsiyaṃ	विसाखापुण्णमासियं
vitakkavūpasamanatthaṃ	वितक्कवूपसमनत्थं
vitakkaṃ	वितक्कं
vitthārato	वित्थारतो
vitthārena	वित्थारेन
vitthārikaṃ	वित्थारिकं
vitthāritasuttesupi	वित्थारितसुत्तेसुपि
vitthāriyamānaṃ	वित्थारियमानं
vitthāriyamāno	वित्थारियमानो
vitthāriyamānā	वित्थारियमाना
vitthāro	वित्थारो
vivajjantu	विवज्जन्तु
vivajjento	विवज्जेन्तो
vivaritvā	विवरित्वा
vivaṇṇetukāmo	विवण्णेतुकामो
vivaṭamatte	विवटमत्ते
vividhanayattā	विविधनयत्ता
viya	विय
viyākaṃsu	वियाकंसु
viyāti	वियाति
viññūnaṃ	विञ्ञूनं
vo	वो
vohārabāhullato	वोहारबाहुल्लतो
vohāradesanā	वोहारदेसना
vohārakusalena	वोहारकुसलेन
vokkamasi	वोक्कमसि
vokkamati	वोक्कमति
vuccanti	वुच्चन्ति
vuccati	वुच्चति
vudakaṃ	वुदकं
vuttadhammānaṃ	वुत्तधम्मानं
vuttanayena	वुत्तनयेन
vuttatthā	वुत्तत्था
vuttattā	वुत्तत्ता
vuttavacanaṃ	वुत्तवचनं
vuttañhetaṃ	वुत्तञ्हेतं
vuttaṃ	वुत्तं
vutte	वुत्ते
vuttoyeva	वुत्तोयेव
vuttā	वुत्ता
vuḍḍhilakkhaṇapūjitaparicchinnādhikesu	वुड्ढिलक्खणपूजितपरिच्छिन्नाधिकेसु
vuḍḍhimanto	वुड्ढिमन्तो
vuḍḍhimantopi	वुड्ढिमन्तोपि
vuḍḍhiyaṃ	वुड्ढियं
vuṭṭhahantassa	वुट्ठहन्तस्स
vuṭṭhahiṃ	वुट्ठहिं
vuṭṭhito	वुट्ठितो
vuṭṭhāpiyamānassa	वुट्ठापियमानस्स
vuṭṭhāya	वुट्ठाय
vā	वा
vācanāmaggato	वाचनामग्गतो
vācanāmaggo	वाचनामग्गो
vācañca	वाचञ्च
vāceti	वाचेति
vācetuñca	वाचेतुञ्च
vācetvā	वाचेत्वा
vādayutti	वादयुत्ति
vādaṃ	वादं
vākacīrasmiñhi	वाकचीरस्मिञ्हि
vākacīrañca	वाकचीरञ्च
vākacīraṃ	वाकचीरं
vākacīre	वाकचीरे
vākacīrāni	वाकचीरानि
vākuppattiyā	वाकुप्पत्तिया
vāladhiṃ	वालधिं
vālaṃ	वालं
vāpitaṃ	वापितं
vāsipharasuhattho	वासिफरसुहत्थो
vāsiṭṭho	वासिट्ठो
vātaṃ	वातं
vātiādinā	वातिआदिना
vāto	वातो
vāyamantassāpissa	वायमन्तस्सापिस्स
vāyamanto	वायमन्तो
vāyanti	वायन्ति
vāyati	वायति
vīriyapāramitā	वीरियपारमिता
vīriyapāramitādīnampi	वीरियपारमितादीनम्पि
vīriyapāramiṃ	वीरियपारमिं
vīriyapāramīti	वीरियपारमीति
vīriyaṃ	वीरियं
vīsabhāṇavārasataṃ	वीसभाणवारसतं
vīsatibhikkhusahassāni	वीसतिभिक्खुसहस्सानि
vīsatihatthubbedhaṃ	वीसतिहत्थुब्बेधं
vīsativassasahassāni	वीसतिवस्ससहस्सानि
vītamalā	वीतमला
vītarāgā	वीतरागा
vīthito	वीथितो
vītikkamapaṭipakkhattā	वीतिक्कमपटिपक्खत्ता
vītikkamappahānaṃ	वीतिक्कमप्पहानं
vītikkame	वीतिक्कमे
vītināmesi	वीतिनामेसि
vītināmetvā	वीतिनामेत्वा
vītipatantamaṇitālavaṇṭaṃ	वीतिपतन्तमणितालवण्टं
vītipatantarajatatālavaṇṭā	वीतिपतन्तरजततालवण्टा
vītivattāni	वीतिवत्तानि
yadi	यदि
yahiṃ	यहिं
yakkhasenāpati	यक्खसेनापति
yakkhaṃ	यक्खं
yakkho	यक्खो
yakkhānaṃ	यक्खानं
yamakappakaraṇaṃ	यमकप्पकरणं
yamakapāṭihāriyaṃ	यमकपाटिहारियं
yamakapāṭihāriye	यमकपाटिहारिये
yamakaṃ	यमकं
yasavatī	यसवती
yasavā	यसवा
yasmā	यस्मा
yaso	यसो
yasodharā	यसोधरा
yassa	यस्स
yassāyaṃ	यस्सायं
yathayidaṃ	यथयिदं
yathicchitaṃ	यथिच्छितं
yathā	यथा
yathābhūtāvabodho	यथाभूतावबोधो
yathādhammasāsana	यथाधम्मसासन
yathādhammaṃ	यथाधम्मं
yathākkamaṃ	यथाक्कमं
yathākkamena	यथाक्कमेन
yathānisinnova	यथानिसिन्नोव
yathānulomasāsanaṃ	यथानुलोमसासनं
yathānulomaṃ	यथानुलोमं
yathāparādhasāsanaṃ	यथापराधसासनं
yathāparādhayathānulomayathādhammasāsanāni	यथापराधयथानुलोमयथाधम्मसासनानि
yathāparādhaṃ	यथापराधं
yathārahaṃ	यथारहं
yathāruci	यथारुचि
yathāsukhaṃ	यथासुखं
yatonidānaṃ	यतोनिदानं
yattha	यत्थ
yañca	यञ्च
yaññadatto	यञ्ञदत्तो
yaṃ	यं
yaṃkiñci	यंकिञ्चि
yaṃnūnāhaṃ	यंनूनाहं
ye	ये
yeme	येमे
yena	येन
yenena	येनेन
yesaṃ	येसं
yo	यो
yogena	योगेन
yojanamattaṃ	योजनमत्तं
yojanappamāṇaṃ	योजनप्पमाणं
yojanattayaṃ	योजनत्तयं
yojane	योजने
yojanāni	योजनानि
yojetvā	योजेत्वा
yugandhare	युगन्धरे
yuttaṃ	युत्तं
yā	या
yācake	याचके
yācanti	याचन्ति
yāci	याचि
yācito	याचितो
yāgubhattavatthādīni	यागुभत्तवत्थादीनि
yāme	यामे
yānake	यानके
yāni	यानि
yāpanaṃ	यापनं
yāpesīti	यापेसीति
yāsaṃ	यासं
yāva	याव
yāvajjatanakālā	यावज्जतनकाला
yāvatā	यावता
yāvatāyukaṃ	यावतायुकं
Ñeyyadhammesu	ञेय्यधम्मेसु
Ñāṇavibhaṅgo	ञाणविभङ्गो
ñatvā	ञत्वा
ñeyyā	ञेय्या
ñāpetabbo	ञापेतब्बो
ñātisamāgame	ञातिसमागमे
ñātisaṅghaparivuto	ञातिसङ्घपरिवुतो
ñāṇabhūto	ञाणभूतो
ñāṇanti	ञाणन्ति
ñāṇassa	ञाणस्स
ñāṇasāgaro	ञाणसागरो
ñāṇasāgaroti	ञाणसागरोति
ñāṇavatthūtiādinā	ञाणवत्थूतिआदिना
ñāṇavibhaṅgo	ञाणविभङ्गो
ñāṇaṃ	ञाणं
ñāṇena	ञाणेन
ñāṇuttarānaṃ	ञाणुत्तरानं
Ābhatā	आभता
Ābhidhammikabhikkhūnampi	आभिधम्मिकभिक्खूनम्पि
Ābhidhammikabhikkhūyeva	आभिधम्मिकभिक्खूयेव
Ābhidhammikā	आभिधम्मिका
Āgacchanto	आगच्छन्तो
Āha	आह
Āhāramūlakassa	आहारमूलकस्स
Ājānāhi	आजानाहि
Ākāsaṭṭhā	आकासट्ठा
Āmantā	आमन्ता
Āmoditā	आमोदिता
Ānandatthero	आनन्दत्थेरो
Ānandattherādīhi	आनन्दत्थेरादीहि
Ānando	आनन्दो
Ānubhāvena	आनुभावेन
Āropayitvā	आरोपयित्वा
Ātāpino	आतापिनो
Āyuppamāṇaṃ	आयुप्पमाणं
ābharaṇesu	आभरणेसु
ābhatassa	आभतस्स
ābhato	आभतो
ābhidhammikabhikkhūnaṃ	आभिधम्मिकभिक्खूनं
ābhidhammikattherānaṃ	आभिधम्मिकत्थेरानं
ābhidhammiko	आभिधम्मिको
ābhidhammikā	आभिधम्मिका
ābhujati	आभुजति
ābhujiṃ	आभुजिं
ābhāya	आभाय
ācariyaparamparāya	आचरियपरम्पराय
ācariyaṃ	आचरियं
ācariyānaṃ	आचरियानं
ācikkhati	आचिक्खति
ācikkhitvā	आचिक्खित्वा
ācāraguṇasampanno	आचारगुणसम्पन्नो
ādayo	आदयो
ādhārakāni	आधारकानि
ādiccova	आदिच्चोव
ādito	आदितो
ādiyinti	आदियिन्ति
ādiṃ	आदिं
ādāya	आदाय
ādīnavaṃ	आदीनवं
ādīnave	आदीनवे
ādīnavo	आदीनवो
ādīnavā	आदीनवा
āgacchantaṃ	आगच्छन्तं
āgacchatūti	आगच्छतूति
āgaccheyya	आगच्छेय्य
āgamanatthāya	आगमनत्थाय
āgamanaṃ	आगमनं
āgamaṭṭhakathāsupi	आगमट्ठकथासुपि
āgametvā	आगमेत्वा
āgami	आगमि
āgamiṃsu	आगमिंसु
āgamma	आगम्म
āgantvā	आगन्त्वा
āgatena	आगतेन
āgato	आगतो
āha	आह
āhaccabhāsitā	आहच्चभासिता
āharasi	आहरसि
āharituṃ	आहरितुं
āharitvā	आहरित्वा
āhariṃ	आहरिं
āharāpetvā	आहरापेत्वा
āhu	आहु
āhutīnaṃ	आहुतीनं
āhārapaccayo	आहारपच्चयो
āhāraṃ	आहारं
ājānāmi	आजानामि
ākappasampannā	आकप्पसम्पन्ना
ākappo	आकप्पो
ākaḍḍhanto	आकड्ढन्तो
ākaṅkhamānena	आकङ्खमानेन
ākaṅkhamānā	आकङ्खमाना
ākāsagaṅgā	आकासगङ्गा
ākāsanabhagatā	आकासनभगता
ākāsato	आकासतो
ākāse	आकासे
ākāsena	आकासेन
ālambanaphalakaṃ	आलम्बनफलकं
ālayaṃ	आलयं
ālokapharaṇasamattho	आलोकफरणसमत्थो
āloḷenti	आलोळेन्ति
āloḷetvā	आलोळेत्वा
āmalakarukkho	आमलकरुक्खो
āmantayāmi	आमन्तयामि
āmantesi	आमन्तेसि
āmantetvā	आमन्तेत्वा
ānanda	आनन्द
ānandakumāro	आनन्दकुमारो
ānandetiādinayapavattā	आनन्देतिआदिनयपवत्ता
ānando	आनन्दो
ānantarikehi	आनन्तरिकेहि
ānisaṃse	आनिसंसे
ānisaṃsehi	आनिसंसेहि
ānisaṃso	आनिसंसो
ānisaṃsā	आनिसंसा
ānubhāvena	आनुभावेन
āpajjamāno	आपज्जमानो
āpajjatīti	आपज्जतीति
āpannasattānaṃ	आपन्नसत्तानं
āpatti	आपत्ति
ārabhi	आरभि
ārabhitvā	आरभित्वा
āraddhavīriyo	आरद्धवीरियो
ārammaṇapaccayo	आरम्मणपच्चयो
ārammaṇapaccayope	आरम्मणपच्चयोपे
ārammaṇādīhi	आरम्मणादीहि
ārocento	आरोचेन्तो
ārocetuṃ	आरोचेतुं
ārocetvā	आरोचेत्वा
ārodanaparidevanaṃ	आरोदनपरिदेवनं
āropetvā	आरोपेत्वा
āruppe	आरुप्पे
āruyha	आरुय्ह
ārāmikakiccaṃ	आरामिककिच्चं
āsanā	आसना
āsanāni	आसनानि
āsavehi	आसवेहि
āsayā	आसया
āsevanapaccayo	आसेवनपच्चयो
āsevitanisevitaṃ	आसेवितनिसेवितं
āsi	आसि
āsiñcamānakhīradhārāsamparikiṇṇā	आसिञ्चमानखीरधारासम्परिकिण्णा
āsiñcamānavilīnasuvaṇṇaṃ	आसिञ्चमानविलीनसुवण्णं
āsuṃ	आसुं
āsāḷhīpuṇṇamadivase	आसाळ्हीपुण्णमदिवसे
āvajjesi	आवज्जेसि
āvaraṇaṃ	आवरणं
āvibhāvatthaṃ	आविभावत्थं
āvunantena	आवुनन्तेन
āvuso	आवुसो
āvusoti	आवुसोति
āvāsaṃ	आवासं
āyapotthakaṃ	आयपोत्थकं
āyasmanto	आयस्मन्तो
āyatanantaraṃ	आयतनन्तरं
āyatanapadeso	आयतनपदेसो
āyatanapaññatti	आयतनपञ्ञत्ति
āyatanavibhaṅgo	आयतनविभङ्गो
āyatanavibhaṅgādayopi	आयतनविभङ्गादयोपि
āyatanayamakaṃ	आयतनयमकं
āyatanā	आयतना
āyu	आयु
āyukkhayaṃ	आयुक्खयं
āyupariyosane	आयुपरियोसने
āyupariyosāne	आयुपरियोसाने
āyuppamāṇanti	आयुप्पमाणन्ति
āyuppamāṇaṃ	आयुप्पमाणं
āyuvaṇṇaissariyayasasampattiādīhi	आयुवण्णइस्सरिययससम्पत्तिआदीहि
āyācitadhammadesano	आयाचितधम्मदेसनो
āyācito	आयाचितो
āyūti	आयूति
āḷhakasahassehi	आळ्हकसहस्सेहि
āḷhakasatasahassehi	आळ्हकसतसहस्सेहि
āḷhakasatehi	आळ्हकसतेहि
āḷārañca	आळारञ्च
āḷārudakānaṃ	आळारुदकानं
āṇābāhullato	आणाबाहुल्लतो
āṇādesanā	आणादेसना
āṇārahena	आणारहेन
āṇāvohāraparamatthadesanā	आणावोहारपरमत्थदेसना
īdisaṃ	ईदिसं
īdiso	ईदिसो
ūkāmaṅgulagharagoḷikādīnaṃ	ऊकामङ्गुलघरगोळिकादीनं
ūmivegappabhedasamuggatajalacuṇṇaparikiṇṇo	ऊमिवेगप्पभेदसमुग्गतजलचुण्णपरिकिण्णो
ūmivego	ऊमिवेगो
ḍaṃseyya	डंसेय्य
Ṭhapento	ठपेन्तो
Ṭhapetvā	ठपेत्वा
ṭhapayitvā	ठपयित्वा
ṭhapento	ठपेन्तो
ṭhapesi	ठपेसि
ṭhapetabbatāya	ठपेतब्बताय
ṭhapetvā	ठपेत्वा
ṭhapitamātikāya	ठपितमातिकाय
ṭhapitaṃ	ठपितं
ṭhapitaṃyeva	ठपितंयेव
ṭhapito	ठपितो
ṭhapitā	ठपिता
ṭhatvā	ठत्वा
ṭhatvāna	ठत्वान
ṭhitapadeneva	ठितपदेनेव
ṭhitassa	ठितस्स
ṭhitaṭṭhānassa	ठितट्ठानस्स
ṭhito	ठितो
ṭhitāni	ठितानि
ṭhānampi	ठानम्पि
ṭhānaṃ	ठानं
ṭhāne	ठाने
ṭhānehi	ठानेहि
ṭhānesu	ठानेसु
ṭhānā	ठाना