1	១
1027	១០២៧
1061	១០៦១
11	១១
110	១១០
110102	១១០១០២
112	១១២
1124	១១២៤
1139	១១៣៩
1143	១១៤៣
1144	១១៤៤
1148	១១៤៨
1152	១១៥២
115385	១១៥៣៨៥
12	១២
1202	១២០២
1203	១២០៣
1205	១២០៥
1221	១២២១
1228	១២២៨
1234	១២៣៤
1236	១២៣៦
1238	១២៣៨
1239	១២៣៩
1274	១២៧៤
13	១៣
1343	១៣៤៣
149	១៤៩
1516	១៥១៦
153154	១៥៣១៥៤
163	១៦៣
16667	១៦៦៦៧
1avidūrenidānakathā	១អវិទូរេនិទានកថា
2133	២១៣៣
2209	២២០៩
2218	២២១៨
2399	២៣៩៩
259	២៥៩
27	២៧
291	២៩១
3	៣
303	៣០៣
3100	៣១០០
3113	៣១១៣
3200	៣២០០
3384	៣៣៨៤
366	៣៦៦
370	៣៧០
407	៤០៧
4129	៤១២៩
417	៤១៧
442	៤៤២
45	៤៥
477	៤៧៧
511	៥១១
5195	៥១៩៥
558	៥៥៨
720	៧២០
75	៧៥
751	៧៥១
8	៨
85	៨៥
99	៩៩
Abbhantaramhi	អព្ភន្តរម្ហិ
Abbocchinnaṃ	អព្ពោច្ឆិន្នំ
Abhidhammakathāmaggaṃ	អភិធម្មកថាមគ្គំ
Abhidhammapiṭake	អភិធម្មបិដកេ
Abhidhammassa	អភិធម្មស្ស
Abhidhammasuttaṃ	អភិធម្មសុត្តំ
Abhidhammaṃ	អភិធម្មំ
Abhidhamme	អភិធម្មេ
Abhidhammo	អភិធម្មោ
Abhikkantena	អភិក្កន្តេន
Abhiññābalamāhari	អភិញ្ញាពលមាហរិ
Acetanaṃva	អចេតនំវ
Acetanāyaṃ	អចេតនាយំ
Adaṃsu	អទំសុ
Adhiṭṭhānapāramitaṃ	អធិដ្ឋានបារមិតំ
Advejjhavacanā	អទ្វេជ្ឈវចនា
Ahampi	អហម្បិ
Ahaṃ	អហំ
Ahu	អហុ
Ajapālarukkhamūle	អជបាលរុក្ខមូលេ
Ajaraṃ	អជរំ
Ajjhāyako	អជ្ឈាយកោ
Akkamitvāna	អក្កមិត្វាន
Akāsabhūtā	អកាសភូតា
Alaṅkatasīsaṃ	អលង្កតសីសំ
Alīnavīriyo	អលីនវីរិយោ
Amaraṃ	អមរំ
Amhākampi	អម្ហាកម្បិ
Ananto	អនន្តោ
Anekaguṇasampannaṃ	អនេកគុណសម្បន្នំ
Anekajātisaṃsāraṃ	អនេកជាតិសំសារំ
Anekakoṭisannicayo	អនេកកោដិសន្និចយោ
Anekāni	អនេកានិ
Aniṭṭhagandho	អនិដ្ឋគន្ធោ
Aniṭṭhite	អនិដ្ឋិតេ
Anomadassissa	អនោមទស្សិស្ស
Anotattadahe	អនោតត្តទហេ
Anovaṭṭhena	អនោវដ្ឋេន
Antalikkhamhi	អន្តលិក្ខម្ហិ
Antarantarā	អន្តរន្តរា
Antobhastagataṃ	អន្តោភស្តគតំ
Anuṭṭhāpanīyabhāvo	អនុដ្ឋាបនីយភាវោ
Anāgatamhi	អនាគតម្ហិ
Anāsavā	អនាសវា
Apanetvā	អបនេត្វា
Aparabhāgepi	អបរភាគេបិ
Aparampissa	អបរម្បិស្ស
Aparepi	អបរេបិ
Aparimeyye	អបរិមេយ្យេ
Aparo	អបរោ
Apaṇṇakajātakādīni	អបណ្ណកជាតកាទីនិ
Appattamānasā	អប្បត្តមានសា
Appaṭijagganatā	អប្បដិជគ្គនតា
Asamo	អសមោ
Assamo	អស្សមោ
Assattharukkhamūlamhi	អស្សត្ថរុក្ខមូលម្ហិ
Asītihatthamubbedho	អសីតិហត្ថមុព្ពេធោ
Atha	អថ
Athassa	អថស្ស
Atheko	អថេកោ
Athāpare	អថាបរេ
Athāpi	អថាបិ
Atirekavisesatthadīpako	អតិរេកវិសេសត្ថទីបកោ
Atisambādhe	អតិសម្ពាធេ
Ativisāle	អតិវិសាលេ
Atthato	អត្ថតោ
Atthaṃ	អត្ថំ
Attheva	អត្ថេវ
Atthi	អត្ថិ
Attho	អត្ថោ
Atthānaṃ	អត្ថានំ
Atīradassī	អតីរទស្សី
Avikkhittā	អវិក្ខិត្តា
Avinayadhāritāya	អវិនយធារិតាយ
Avīcimhi	អវីចិម្ហិ
Ayamettha	អយមេត្ថ
Ayameva	អយមេវ
Ayampi	អយម្បិ
Ayañca	អយញ្ច
Ayañhi	អយញ្ហិ
Ayaṃ	អយំ
Aññepi	អញ្ញេបិ
Aññesu	អញ្ញេសុ
Aṭṭhadhammasamodhānā	អដ្ឋធម្មសមោធានា
Aṭṭhadosasamākiṇṇaṃ	អដ្ឋទោសសមាកិណ្ណំ
Aṭṭhaguṇasamupeta	អដ្ឋគុណសមុបេត
Aṭṭhaguṇasamupetaṃ	អដ្ឋគុណសមុបេតំ
Aṭṭhasālinī	អដ្ឋសាលិនី
Aṭṭhimāni	អដ្ឋិមានិ
Aṭṭhīhi	អដ្ឋីហិ
Bahū	ពហូ
Bandhumatī	ពន្ធុមតី
Bhagavā	ភគវា
Bhante	ភន្តេ
Bhayaṃ	ភយំ
Bhaṇḍacchedabhayaṃ	ភណ្ឌច្ឆេទភយំ
Bhikkhunā	ភិក្ខុនា
Bhikkhāya	ភិក្ខាយ
Bhikkhū	ភិក្ខូ
Bhikkhūnaṃ	ភិក្ខូនំ
Bhojaputte	ភោជបុត្តេ
Bilāsayā	ពិលាសយា
Bodhaneyyaṃ	ពោធនេយ្យំ
Bodhi	ពោធិ
Brahmadatto	ព្រហ្មទត្តោ
Brahmajālādicatuttiṃsasuttasaṅgaho	ព្រហ្មជាលាទិចតុត្តិំសសុត្តសង្គហោ
Brāhmaṇa	ព្រាហ្មណ
Brāhmaṇo	ព្រាហ្មណោ
Buddhassa	ពុទ្ធស្ស
Buddho	ពុទ្ធោ
Buddhoti	ពុទ្ធោតិ
Buddhānañhi	ពុទ្ធានញ្ហិ
Bāhirakadānañhi	ពាហិរកទានញ្ហិ
Bāvīsatindriyāni	ពាវីសតិន្ទ្រិយានិ
Bāḷhā	ពាឡ្ហា
Cajato	ចជតោ
Cakkavāḷasahassehi	ចក្កវាឡសហស្សេហិ
Calatā	ចលតា
Campakaṃ	ចម្បកំ
Candasūriyatārakarūpadevatuyyānavimānakapparukkhānaṃ	ចន្ទសូរិយតារករូបទេវតុយ្យានវិមានកប្បរុក្ខានំ
Caranti	ចរន្តិ
Cattāri	ចត្តារិ
Cattāro	ចត្តារោ
Cattārome	ចត្តារោមេ
Catunahutādhikadviyojanasatasahassabahalā	ចតុនហុតាធិកទ្វិយោជនសតសហស្សពហលា
Caturo	ចតុរោ
Caturāsīti	ចតុរាសីតិ
Catutthe	ចតុត្ថេ
Catuttiṃseva	ចតុត្តិំសេវ
Catūhi	ចតូហិ
Caṅkamanassa	ចង្កមនស្ស
Caṅkamaṃ	ចង្កមំ
Cha	ឆ
Chanahutādhikanavayojanasatasahassabahalo	ឆនហុតាធិកនវយោជនសតសហស្សពហលោ
Chavito	ឆវិតោ
Chaḍḍayitvāna	ឆឌ្ឌយិត្វាន
Cittapariyādānasuttādinavasuttasahassapañcasatasattapaññāsasuttasaṅgaho	ចិត្តបរិយាទានសុត្តាទិនវសុត្តសហស្សបញ្ចសតសត្តបញ្ញាសសុត្តសង្គហោ
Cittasamuṭṭhānā	ចិត្តសមុដ្ឋានា
Cittassa	ចិត្តស្ស
Cittavibhatti	ចិត្តវិភត្តិ
Citto	ចិត្តោ
Cittuppādakaṇḍa	ចិត្តុប្បាទកណ្ឌ
Cittuppādakaṇḍo	ចិត្តុប្បាទកណ្ឌោ
Cutī	ចុតី
Cūḷavedallamahāvedallasammādiṭṭhisakkapañhasaṅkhārabhājanīyamahāpuṇṇamasuttādayo	ចូឡវេទល្លមហាវេទល្លសម្មាទិដ្ឋិសក្កបញ្ហសង្ខារភាជនីយមហាបុណ្ណមសុត្តាទយោ
Dabbasambhāre	ទព្ពសម្ភារេ
Dadāhi	ទទាហិ
Dasahi	ទសហិ
Dasasahassilokamhi	ទសសហស្សិលោកម្ហិ
Dasasahassī	ទសសហស្សី
Dasavidho	ទសវិធោ
Dasavīsasahassānaṃ	ទសវីសសហស្សានំ
Dassanaṃ	ទស្សនំ
Dayāya	ទយាយ
Daḷhaṃ	ទឡ្ហំ
Desanā	ទេសនា
Desanānidānaṃ	ទេសនានិទានំ
Desanāsāsanakathābhedaṃ	ទេសនាសាសនកថាភេទំ
Devatā	ទេវតា
Devatāsaṃyuttādivasena	ទេវតាសំយុត្តាទិវសេន
Devā	ទេវា
Dhammahadayavibhaṅgo	ធម្មហទយវិភង្គោ
Dhammanāvaṃ	ធម្មនាវំ
Dhammapadabhāṇakā	ធម្មបទភាណកា
Dhammapadaṃ	ធម្មបទំ
Dhammappaṭiggāhakā	ធម្មប្បដិគ្គាហកា
Dhammasaṅgaṇīaṭṭhakathā	ធម្មសង្គណីអដ្ឋកថា
Dhammasaṅgaṇīādīni	ធម្មសង្គណីអាទីនិ
Dhammasenāpatisāriputtattherappabhavā	ធម្មសេនាបតិសារិបុត្តត្ថេរប្បភវា
Dhammasenāpatisāriputtattheropi	ធម្មសេនាបតិសារិបុត្តត្ថេរោបិ
Dhammatejena	ធម្មតេជេន
Dhammaṃ	ធម្មំ
Dhamme	ធម្មេ
Dhammo	ធម្មោ
Dhammātirekadhammavisesaṭṭhena	ធម្មាតិរេកធម្មវិសេសដ្ឋេន
Dhunanto	ធុនន្តោ
Dibbasaṅgītivattanakālo	ទិព្ពសង្គីតិវត្តនកាលោ
Dibbaṃ	ទិព្ពំ
Disodisaṃ	ទិសោទិសំ
Divā	ទិវា
Diyaḍḍhasatasuttantā	ទិយឌ្ឍសតសុត្តន្តា
Duggahitattā	ទុគ្គហិតត្តា
Dukasataṃ	ទុកសតំ
Dukatikañceva	ទុកតិកញ្ចេវ
Duke	ទុកេ
Dukkho	ទុក្ខោ
Dutiye	ទុតិយេ
Dutiyābhisamaye	ទុតិយាភិសមយេ
Dvepi	ទ្វេបិ
Dvādasaguṇamupāgata	ទ្វាទសគុណមុបាគត
Dvādasapadikaṃ	ទ្វាទសបទិកំ
Dvādasaterasayojanappamāṇaṃ	ទ្វាទសតេរសយោជនប្បមាណំ
Dvādasaterasayojanappamāṇo	ទ្វាទសតេរសយោជនប្បមាណោ
Dvādasāyatanāni	ទ្វាទសាយតនានិ
Dvāsaṭṭhi	ទ្វាសដ្ឋិ
Dvāsīti	ទ្វាសីតិ
Dvāvīsatitike	ទ្វាវីសតិតិកេ
Dānapāramitaṃ	ទានបារមិតំ
Dānena	ទានេន
Dīghappamāṇānaṃ	ទីឃប្បមាណានំ
Dīpaṅkarassa	ទីបង្ករស្ស
Dīpaṅkaraṃ	ទីបង្ករំ
Dīpaṅkaro	ទីបង្ករោ
Ekadvinnaṃ	ឯកទ្វិន្នំ
Ekamekasmiñcettha	ឯកមេកស្មិញ្ចេត្ថ
Ekantena	ឯកន្តេន
Ekarājajātake	ឯករាជជាតកេ
Ekaṃ	ឯកំ
Ekekaaṅgātirekavasena	ឯកេកអង្គាតិរេកវសេន
Ekuttariyaṃ	ឯកុត្តរិយំ
Esa	ឯស
Eso	ឯសោ
Esānisaṃso	ឯសានិសំសោ
Ettakaṃ	ឯត្តកំ
Ettakesu	ឯត្តកេសុ
Ettako	ឯត្តកោ
Ettakāyeva	ឯត្តកាយេវ
Ettha	ឯត្ថ
Ettāvatā	ឯត្តាវតា
Evamassa	ឯវមស្ស
Evametaṃ	ឯវមេតំ
Evametesu	ឯវមេតេសុ
Evameva	ឯវមេវ
Evamevāhaṃ	ឯវមេវាហំ
Evampi	ឯវម្បិ
Evamādīni	ឯវមាទីនិ
Evaṃ	ឯវំ
Evāhaṃ	ឯវាហំ
Gahakāraka	គហការក
Gahakāraṃ	គហការំ
Gahetabbaṃ	គហេតព្ពំ
Gambhīraṃ	គម្ភីរំ
Ganthārambhakathā	គន្ថារម្ភកថា
Gavapānanti	គវបានន្តិ
Ghaṭānekasahassāni	ឃដានេកសហស្សានិ
Gāmavāsī	គាមវាសី
Gāmaṇḍalā	គាមណ្ឌលា
Gāthābandhesu	គាថាពន្ធេសុ
Handa	ហន្ទ
Hatthisaddaṃ	ហត្ថិសទ្ទំ
Haṭṭhatuṭṭhena	ហដ្ឋតុដ្ឋេន
Heṭṭhā	ហេដ្ឋា
Himavantassāvidūre	ហិមវន្តស្សាវិទូរេ
Icchamāno	ឥច្ឆមានោ
Idaṃ	ឥទំ
Idha	ឥធ
Idāni	ឥទានិ
Imasmiṃ	ឥមស្មិំ
Imassa	ឥមស្ស
Imassāpi	ឥមស្សាបិ
Imañhi	ឥមញ្ហិ
Imaṃ	ឥមំ
Ime	ឥមេ
Imehi	ឥមេហិ
Imesu	ឥមេសុ
Iminā	ឥមិនា
Imāni	ឥមានិ
Indriyavibhaṅge	ឥន្ទ្រិយវិភង្គេ
Itaraṃ	ឥតរំ
Iti	ឥតិ
Ito	ឥតោ
Itthibhāvaṃ	ឥត្ថិភាវំ
Jalitvā	ជលិត្វា
Jambudīpā	ជម្ពុទីបា
Jhānavibhaṅgo	ឈានវិភង្គោ
Jotayitvāna	ជោតយិត្វាន
Jātidhammo	ជាតិធម្មោ
Jāyamānā	ជាយមានា
Kadā	កទា
Kakusandhassa	កកុសន្ធស្ស
Kalale	កលលេ
Kammaṭṭhānāni	កម្មដ្ឋានានិ
Kappe	កប្បេ
Karuṇā	ករុណា
Kasmā	កស្មា
Kassa	កស្ស
Kassaci	កស្សចិ
Kassatthāya	កស្សត្ថាយ
Katamo	កតមោ
Katamā	កតមា
Kataraṃ	កតរំ
Katañjalī	កតញ្ជលី
Kathaṃ	កថំ
Kathāvatthunāva	កថាវត្ថុនាវ
Kattha	កត្ថ
Kañci	កញ្ចិ
Ke	កេ
Kehi	កេហិ
Kena	កេន
Kenābhato	កេនាភតោ
Kenābhatoti	កេនាភតោតិ
Kenādhigato	កេនាធិគតោ
Kesamassūhi	កេសមស្សូហិ
Kese	កេសេ
Kevalañhettha	កេវលញ្ហេត្ថ
Kevalañhi	កេវលញ្ហិ
Khandhānañca	ខន្ធានញ្ច
Khantipāramitaṃ	ខន្តិបារមិតំ
Khantivādījātake	ខន្តិវាទីជាតកេ
Khaṇena	ខណេន
Khemā	ខេមា
Khuddakapāṭhadhammapadaudānaitivuttakasuttanipātavimānavatthupetavatthutheragāthātherīgāthājātakaniddesapaṭisambhidāapadānabuddhavaṃsacariyāpiṭakavasena	ខុទ្ទកបាឋធម្មបទឧទានឥតិវុត្តកសុត្តនិបាតវិមានវត្ថុបេតវត្ថុថេរគាថាថេរីគាថាជាតកនិទ្ទេសបដិសម្ភិទាអបទានពុទ្ធវំសចរិយាបិដកវសេន
Khuddakavatthuvibhaṅgopi	ខុទ្ទកវត្ថុវិភង្គោបិ
Khādatha	ខាទថ
Khīṇāsavehi	ខីណាសវេហិ
Khīṇāsavā	ខីណាសវា
Kimatthaṃ	កិមត្ថំ
Kisāgotamiyā	កិសាគោតមិយា
Kiṃ	កិំ
Kolito	កោលិតោ
Koṇe	កោណេ
Koṇḍaññabuddhassa	កោណ្ឌញ្ញពុទ្ធស្ស
Koṭisatasahassasaṅkhyānaṃ	កោដិសតសហស្សសង្ខ្យានំ
Koṭisatasahassānaṃ	កោដិសតសហស្សានំ
Kulāni	កុលានិ
Kusalattikādayo	កុសលត្តិកាទយោ
Kuṭṭā	កុដ្ដា
Kālo	កាលោ
Kāsirāje	កាសិរាជេ
Kāyikavācasikaajjhācāranisedhanato	កាយិកវាចសិកអជ្ឈាចារនិសេធនតោ
Lakkhaṇe	លក្ខណេ
Latā	លតា
Lomahaṃsajātake	លោមហំសជាតកេ
Madhupiṇḍikasuttantasmiñhi	មធុបិណ្ឌិកសុត្តន្តស្មិញ្ហិ
Mahaggatā	មហគ្គតា
Mahantaṃ	មហន្តំ
Mahesakkhā	មហេសក្ខា
Mahesinā	មហេសិនា
Mahābodhipallaṅkasmiñhi	មហាពោធិបល្លង្កស្មិញ្ហិ
Mahādhammahadayaṃ	មហាធម្មហទយំ
Mahādhammahadaye	មហាធម្មហទយេ
Mahādhātukathāyaṃ	មហាធាតុកថាយំ
Mahāgosiṅgasuttaṃ	មហាគោសិង្គសុត្តំ
Mahāhanusabhakkhandho	មហាហនុសភក្ខន្ធោ
Mahājanā	មហាជនា
Mahānādaṃ	មហានាទំ
Mahāpakaraṇe	មហាបករណេ
Mahāpurisassa	មហាបុរិសស្ស
Mahāpuriso	មហាបុរិសោ
Mahārajjaṃ	មហារជ្ជំ
Mahāsamuddo	មហាសមុទ្ទោ
Mahāsatto	មហាសត្តោ
Mahāsutasomajātake	មហាសុតសោមជាតកេ
Mahāvihāravāsīnaṃ	មហាវិហារវាសីនំ
Mahāvātā	មហាវាតា
Majjhimappamāṇāni	មជ្ឈិមប្បមាណានិ
Mama	មម
Manussattaṃ	មនុស្សត្តំ
Manussāyeva	មនុស្សាយេវ
Mayampetaṃ	មយម្បេតំ
Mañjiṭṭhapabhassarā	មញ្ជិដ្ឋបភស្សរា
Maṃsalohitehi	មំសលោហិតេហិ
Maṅgalassa	មង្គលស្ស
Maṇḍalārāmavāsī	មណ្ឌលារាមវាសី
Mettābalenupatthaddho	មេត្តាពលេនុបត្ថទ្ធោ
Mettāpāramitaṃ	មេត្តាបារមិតំ
Mettāya	មេត្តាយ
Micchādiṭṭhiṃ	មិច្ឆាទិដ្ឋិំ
Mocayitvāna	មោចយិត្វាន
Mocesiṃ	មោចេសិំ
Moggaliputtatissattheropi	មោគ្គលិបុត្តតិស្សត្ថេរោបិ
Mudusamatale	មុទុសមតលេ
Muttā	មុត្តា
Mā	មា
Mānussakā	មានុស្សកា
Mātaraṃ	មាតរំ
Mātā	មាតា
Mūgapakkhajātake	មូគបក្ខជាតកេ
Mūlapariyāyasuttādidiyaḍḍhasatadvesuttasaṅgaho	មូលបរិយាយសុត្តាទិទិយឌ្ឍសតទ្វេសុត្តសង្គហោ
Mūlato	មូលតោ
Na	ន
Nagaraṃ	នគរំ
Nagare	នគរេ
Nahevaṃ	នហេវំ
Namo	នមោ
Nandā	នន្ទា
Nanu	ននុ
Narā	នរា
Nava	នវ
Navadosamupāgata	នវទោសមុបាគត
Navutikoṭisahassehi	នវុតិកោដិសហស្សេហិ
Navutikoṭisahassānaṃ	នវុតិកោដិសហស្សានំ
Navutivassasahassāni	នវុតិវស្សសហស្សានិ
Nekkhammaninnā	នេក្ខម្មនិន្នា
Nekkhammapāramitaṃ	នេក្ខម្មបារមិតំ
Nekkhammābhimukho	នេក្ខម្មាភិមុខោ
Nerañjarāya	នេរញ្ជរាយ
Nibbutā	និព្ពុតា
Nidānakathā	និទានកថា
Nijjhāmataṇhā	និជ្ឈាមតណ្ហា
Nikkhepakaṇḍa	និក្ខេបកណ្ឌ
Nikkhipitvā	និក្ខិបិត្វា
Nikāyantaraladdhīhi	និកាយន្តរលទ្ធីហិ
Nikāyo	និកាយោ
Nimittāni	និមិត្តានិ
Nipaccakārassetassa	និបច្ចការស្សេតស្ស
Nirayepi	និរយេបិ
No	នោ
Nāhaṃ	នាហំ
Nāmaṃ	នាមំ
Nānānayavicittassa	នានានយវិចិត្តស្ស
Nāradabuddhassa	នារទពុទ្ធស្ស
Nāthānāthānaṃ	នាថានាថានំ
Oghataraṇasuttādisattasuttasahassasattasatadvāsaṭṭhisuttasaṅgaho	ឱឃតរណសុត្តាទិសត្តសុត្តសហស្សសត្តសតទ្វាសដ្ឋិសុត្តសង្គហោ
Olokentassevassa	ឱលោកេន្តស្សេវស្ស
Orohitvāna	ឱរោហិត្វាន
Pabbajitvā	បព្ពជិត្វា
Pabbajjā	បព្ពជ្ជា
Pabhā	បភា
Paccantadesavisaye	បច្ចន្តទេសវិសយេ
Paccanīyapaṭṭhānepi	បច្ចនីយបដ្ឋានេបិ
Paccayavasena	បច្ចយវសេន
Paccayākāravibhaṅgo	បច្ចយាការវិភង្គោ
Pacchābhattaṃ	បច្ឆាភត្តំ
Paccuggamanā	បច្ចុគ្គមនា
Padhānaṃ	បធានំ
Padumassa	បទុមស្ស
Padumuttarassa	បទុមុត្តរស្ស
Padānukkamato	បទានុក្កមតោ
Pahāyimaṃ	បហាយិមំ
Pakaraṇaparicchedato	បករណបរិច្ឆេទតោ
Pallaṅkena	បល្លង្កេន
Pallaṅkābhujane	បល្លង្កាភុជនេ
Paribhuñjantassa	បរិភុញ្ជន្តស្ស
Pariggahakaraṇābhāvo	បរិគ្គហករណាភាវោ
Parirakkha	បរិរក្ខ
Pariyattibhedaṃ	បរិយត្តិភេទំ
Pariyattipi	បរិយត្តិបិ
Pariyesissāmi	បរិយេសិស្សាមិ
Pariyosānadivase	បរិយោសានទិវសេ
Passatha	បស្សថ
Pathavisandhārakaṃ	បថវិសន្ធារកំ
Pathaviyaṃ	បថវិយំ
Pavedhamānā	បវេធមានា
Pañcadosavivajjita	បញ្ចទោសវិវជ្ជិត
Paññāpāramitaṃ	បញ្ញាបារមិតំ
Paññāya	បញ្ញាយ
Paṇḍito	បណ្ឌិតោ
Paṇṇasālā	បណ្ណសាលា
Paṇṇasālāparibhogasmiñhi	បណ្ណសាលាបរិភោគស្មិញ្ហិ
Paṭhamasannipāte	បឋមសន្និបាតេ
Paṭhame	បឋមេ
Paṭhamābhisamaye	បឋមាភិសមយេ
Paṭibalo	បដិពលោ
Paṭijagganeneva	បដិជគ្គនេនេវ
Paṭivedho	បដិវេធោ
Paṭiyattavaramaggena	បដិយត្តវរមគ្គេន
Paṭṭhāna	បដ្ឋាន
Phasso	ផស្សោ
Pitā	បិតា
Pitāpi	បិតាបិ
Piyadassissāpi	បិយទស្សិស្សាបិ
Piṭakaṃ	បិដកំ
Pubbakehi	បុព្ពកេហិ
Puna	បុន
Punapariyesanāya	បុនបរិយេសនាយ
Puthulato	បុថុលតោ
Puṇṇamāye	បុណ្ណមាយេ
Pāpuṇāti	បាបុណាតិ
Pāramiyo	បារមិយោ
Pāricchattakamūlamhi	បារិច្ឆត្តកមូលម្ហិ
Pāṭihīrāvasānamhi	បាដិហីរាវសានម្ហិ
Pītiyā	បីតិយា
Rahogato	រហោគតោ
Rajo	រជោ
Rogo	រោគោ
Rogā	រោគា
Rukkhapathavīpabbatasamuddādayo	រុក្ខបថវីបព្ពតសមុទ្ទាទយោ
Rāhumutto	រាហុមុត្តោ
Rājābhirājā	រាជាភិរាជា
Rājārahabhaṇḍatāya	រាជារហភណ្ឌតាយ
Rūpakaṇḍa	រូបកណ្ឌ
Rūpārammaṇaṃ	រូបារម្មណំ
Sabbacakkavāḷesu	សព្ពចក្កវាឡេសុ
Sabbameva	សព្ពមេវ
Sabbampi	សព្ពម្បិ
Sabbattha	សព្ពត្ថ
Sabbaññutaññāṇaṃ	សព្ពញ្ញុតញ្ញាណំ
Sabbaññutaṃ	សព្ពញ្ញុតំ
Sabbaṃ	សព្ពំ
Sabbe	សព្ពេ
Sabbepi	សព្ពេបិ
Sabbo	សព្ពោ
Sabbā	សព្ពា
Sabbītiyo	សព្ពីតិយោ
Saccapāramitaṃ	សច្ចបារមិតំ
Saccavācaṃ	សច្ចវាចំ
Saddhammañcassa	សទ្ធម្មញ្ចស្ស
Sadevakaṃ	សទេវកំ
Saha	សហ
Sakalampi	សកលម្បិ
Sakalaraṭṭhavāsino	សកលរដ្ឋវាសិនោ
Sakalaṃ	សកលំ
Sakkhissāmi	សក្ខិស្សាមិ
Sakko	សក្កោ
Samaye	សមយេ
Samaṃ	សមំ
Samiddhaṃ	សមិទ្ធំ
Sammāsambuddhassa	សម្មាសម្ពុទ្ធស្ស
Sammāsambuddhena	សម្មាសម្ពុទ្ធេន
Sammāsambuddho	សម្មាសម្ពុទ្ធោ
Sammāsambuddhova	សម្មាសម្ពុទ្ធោវ
Samokiranti	សមោកិរន្តិ
Samādayitvā	សមាទយិត្វា
Samūhanivāsā	សមូហនិវាសា
Sannipātā	សន្និបាតា
Sannisinnena	សន្និសិន្នេន
Saraṇāgamane	សរណាគមនេ
Satasahassavassāni	សតសហស្សវស្សានិ
Sataṃ	សតំ
Satipaṭṭhānavibhaṅgo	សតិបដ្ឋានវិភង្គោ
Satta	សត្ត
Sattannaṃ	សត្តន្នំ
Sattapaññāsasuttāni	សត្តបញ្ញាសសុត្តានិ
Sattappakaraṇānīti	សត្តប្បករណានីតិ
Sattaratanasampannaṃ	សត្តរតនសម្បន្នំ
Satthu	សត្ថុ
Satthā	សត្ថា
Satthāpi	សត្ថាបិ
Savati	សវតិ
Sayaṃ	សយំ
Sañcuṇṇamathitā	សញ្ចុណ្ណមថិតា
Saṃsaraṃ	សំសរំ
Saṃsārasotaṃ	សំសារសោតំ
Saṅghanavakabhikkhunā	សង្ឃនវកភិក្ខុនា
Saṅgītikāle	សង្គីតិកាលេ
Saṅgītipariyosāne	សង្គីតិបរិយោសានេ
Saṅgītā	សង្គីតា
Saṇhasukhumadhammaṃ	សណ្ហសុខុមធម្មំ
Sekkhā	សេក្ខា
Sesaṭṭhānesu	សេសដ្ឋានេសុ
Sikhissāpi	សិខិស្សាបិ
Sikkhāpadavibhaṅgepi	សិក្ខាបទវិភង្គេបិ
Sikkhāpahānagambhīrabhāvañca	សិក្ខាបហានគម្ភីរភាវញ្ច
Silāsane	សិលាសនេ
So	សោ
Sobhati	សោភតិ
Somanassañāṇamayikagāthāppaṭisaṃyuttā	សោមនស្សញាណមយិកគាថាប្បដិសំយុត្តា
Sopajja	សោបជ្ជ
Sopi	សោបិ
Sotavekallatā	សោតវេកល្លតា
Suddhāvāsesu	សុទ្ធាវាសេសុ
Suggahitattā	សុគ្គហិតត្តា
Sukhena	សុខេន
Sumaṅgalo	សុមង្គលោ
Sumedhakathā	សុមេធកថា
Sumedhapaṇḍito	សុមេធបណ្ឌិតោ
Sumedhassa	សុមេធស្ស
Sumedhassāpi	សុមេធស្សាបិ
Sumedhā	សុមេធា
Supupphitaṃ	សុបុប្ផិតំ
Susāne	សុសានេ
Suttantañca	សុត្តន្តញ្ច
Suttantañhi	សុត្តន្តញ្ហិ
Suttantaṃ	សុត្តន្តំ
Suttante	សុត្តន្តេ
Suttasabhāgañcetaṃ	សុត្តសភាគញ្ចេតំ
Sutte	សុត្តេ
Suttāṇā	សុត្តាណា
Suvuttā	សុវុត្តា
Suṭṭhu	សុដ្ឋុ
Svātanāya	ស្វាតនាយ
Svāyaṃ	ស្វាយំ
Sā	សា
Sādhu	សាធុ
Sāgato	សាគតោ
Sāmī	សាមី
Sāpi	សាបិ
Sāriputta	សារិបុត្ត
Sāriputtattheropi	សារិបុត្តត្ថេរោបិ
Sāvatthivāsīnaṃ	សាវត្ថិវាសីនំ
Sāyaṃ	សាយំ
Sāṭakaṃ	សាដកំ
Sīho	សីហោ
Sīlapāramitaṃ	សីលបារមិតំ
Sīlapāramiñca	សីលបារមិញ្ច
Sītaṃ	សីតំ
Sūdati	សូទតិ
Sūlehipi	សូលេហិបិ
Sūriyova	សូរិយោវ
Tadanantaraṃ	តទនន្តរំ
Tadaññaṃ	តទញ្ញំ
Tadā	តទា
Tampajjubbhijjate	តម្បជ្ជុព្ភិជ្ជតេ
Tampi	តម្បិ
Tasmiṃ	តស្មិំ
Tasmā	តស្មា
Tassa	តស្ស
Tassāpi	តស្សាបិ
Tatheva	តថេវ
Tathevimaṃ	តថេវិមំ
Tathā	តថា
Tatiye	តតិយេ
Tato	តតោ
Tatra	តត្រ
Tatridaṃ	តត្រិទំ
Tatrime	តត្រិមេ
Tatrāyaṃ	តត្រាយំ
Tattha	តត្ថ
Tatthappadhānaṃ	តត្ថប្បធានំ
Tatuddhaṃ	តតុទ្ធំ
Tayo	តយោ
Tañhi	តញ្ហិ
Taṃ	តំ
Te	តេ
Tehi	តេហិ
Telayante	តេលយន្តេ
Temāsaṃ	តេមាសំ
Tena	តេន
Tenetametassa	តេនេតមេតស្ស
Tenāha	តេនាហ
Tenāyaṃ	តេនាយំ
Tepajja	តេបជ្ជ
Tepajjubho	តេបជ្ជុភោ
Tepi	តេបិ
Tepiṭakaṃ	តេបិដកំ
Tesaṃ	តេសំ
Tesu	តេសុ
Thaddhavisamabhūmibhāgasmiñhi	ថទ្ធវិសមភូមិភាគស្មិញ្ហិ
Thalajā	ថលជា
Therassa	ថេរស្ស
Therassāpi	ថេរស្សាបិ
Thero	ថេរោ
Tikatikañceva	តិកតិកញ្ចេវ
Tikañca	តិកញ្ច
Tike	តិកេ
Tiriyabhāgehi	តិរិយភាគេហិ
Tisahassimahāsahassilokadhātuyā	តិសហស្សិមហាសហស្សិលោកធាតុយា
Tissassa	តិស្សស្ស
Tisso	តិស្សោ
Tivaggasaṅgahāni	តិវគ្គសង្គហានិ
Tiṇalatādigahanacchanne	តិណលតាទិគហនច្ឆន្នេ
Tiṇapaṇṇamattikāsu	តិណបណ្ណមត្តិកាសុ
Tulābhūto	តុលាភូតោ
Tusitapurato	តុសិតបុរតោ
Tuṭṭhahaṭṭho	តុដ្ឋហដ្ឋោ
Tvaṃ	ត្វំ
Tāni	តានិ
Tānipajja	តានិបជ្ជ
Tāpasapabbajjaṃ	តាបសបព្ពជ្ជំ
Tārāgaṇā	តារាគណា
Tāvadeva	តាវទេវ
Tāvatā	តាវតា
Tīsupi	តីសុបិ
Ubbiggā	ឧព្ពិគ្គា
Ubhinnamantare	ឧភិន្នមន្តរេ
Ubhinnampi	ឧភិន្នម្បិ
Ubhopi	ឧភោបិ
Udakaṃ	ឧទកំ
Uddhaṃ	ឧទ្ធំ
Ukkuṭṭhisaddā	ឧក្កុដ្ឋិសទ្ទា
Upagacchuṃ	ឧបគច្ឆុំ
Uparibhāgena	ឧបរិភាគេន
Upekkhati	ឧបេក្ខតិ
Upekkhāpāramitaṃ	ឧបេក្ខាបារមិតំ
Upeti	ឧបេតិ
Uppajjante	ឧប្បជ្ជន្តេ
Upāgamiṃ	ឧបាគមិំ
Ussīsake	ឧស្សីសកេ
Uttarimanussadhammapeyyālaṃ	ឧត្តរិមនុស្សធម្មបេយ្យាលំ
Uttarā	ឧត្តរា
Vamate	វមតេ
Vasamānāpi	វសមានាបិ
Vasībhūto	វសីភូតោ
Vedajātaṃ	វេទជាតំ
Vedayanti	វេទយន្តិ
Vemātikabhātā	វេមាតិកភាតា
Vibhaṅgappakaraṇaṃ	វិភង្គប្បករណំ
Vicinanto	វិចិនន្តោ
Vicittapupphā	វិចិត្តបុប្ផា
Vidhūpayaṃ	វិធូបយំ
Vimalo	វិមលោ
Vinayadharabhikkhūnañhi	វិនយធរភិក្ខូនញ្ហិ
Vinayamattameva	វិនយមត្តមេវ
Vinayamattassapi	វិនយមត្តស្សបិ
Vinayapiṭake	វិនយបិដកេ
Vinayatthavidūhi	វិនយត្ថវិទូហិ
Vinayañca	វិនយញ្ច
Vinaye	វិនយេ
Visayato	វិសយតោ
Visaṅkhāragataṃ	វិសង្ខារគតំ
Visesena	វិសេសេន
Vissatthā	វិស្សត្ថា
Visuddhimagge	វិសុទ្ធិមគ្គេ
Visuddhācārasīlena	វិសុទ្ធាចារសីលេន
Visākhā	វិសាខា
Vitathaṃ	វិតថំ
Vitaṇḍavādī	វិតណ្ឌវាទី
Vitthārikaṃ	វិត្ថារិកំ
Vitthāriyamānaṃ	វិត្ថារិយមានំ
Vitthāro	វិត្ថារោ
Vividhavisesanayattā	វិវិធវិសេសនយត្តា
Vividhā	វិវិធា
Vuttañhetaṃ	វុត្តញ្ហេតំ
Vuttādhikā	វុត្តាធិកា
Vākacīraṃ	វាកចីរំ
Vāpitaṃ	វាបិតំ
Vātaṃ	វាតំ
Vīriyapāramitaṃ	វីរិយបារមិតំ
Yadi	យទិ
Yadimassa	យទិមស្ស
Yadā	យទា
Yakkho	យក្ខោ
Yamahaṃ	យមហំ
Yamakapāṭihāriyaṃ	យមកបាដិហារិយំ
Yamakasālānamantare	យមកសាលានមន្តរេ
Yamhi	យម្ហិ
Yasmā	យស្មា
Yassa	យស្ស
Yathā	យថា
Yathānupubbaṃ	យថានុបុព្ពំ
Yathāpi	យថាបិ
Yathāvutteneva	យថាវុត្តេនេវ
Yato	យតោ
Yatohaṃ	យតោហំ
Yañca	យញ្ច
Yaṃ	យំ
Yaṃnūnimaṃ	យំនូនិមំ
Ye	យេ
Yo	យោ
Yā	យា
Yāvatā	យាវតា
a	អ
abbhokāsāvāso	អព្ភោកាសាវាសោ
abbhuggantvā	អព្ភុគ្គន្ត្វា
abbhutadhamma	អព្ភុតធម្ម
abbhutadhammaṃ	អព្ភុតធម្មំ
abbhutā	អព្ភុតា
abbhācikkhati	អព្ភាចិក្ខតិ
abhayo	អភយោ
abhibhū	អភិភូ
abhidhammadesanāpariyosānañca	អភិធម្មទេសនាបរិយោសានញ្ច
abhidhammakathaṃ	អភិធម្មកថំ
abhidhammanayasamuddaṃ	អភិធម្មនយសមុទ្ទំ
abhidhammapiṭakanti	អភិធម្មបិដកន្តិ
abhidhammapiṭakaṃ	អភិធម្មបិដកំ
abhidhammapiṭake	អភិធម្មបិដកេ
abhidhammassa	អភិធម្មស្ស
abhidhammatantiṃ	អភិធម្មតន្តិំ
abhidhammato	អភិធម្មតោ
abhidhammañca	អភិធម្មញ្ច
abhidhammaṃ	អភិធម្មំ
abhidhamme	អភិធម្មេ
abhidhammo	អភិធម្មោ
abhidhammoti	អភិធម្មោតិ
abhijāti	អភិជាតិ
abhikkama	អភិក្កម
abhikkamanti	អភិក្កមន្តិ
abhikkantavaṇṇātiādīsu	អភិក្កន្តវណ្ណាតិអាទីសុ
abhilakkhitātiādīsu	អភិលក្ខិតាតិអាទីសុ
abhimukho	អភិមុខោ
abhinanditabbaṃ	អភិនន្ទិតព្ពំ
abhinīhāro	អភិនីហារោ
abhiravanti	អភិរវន្តិ
abhirūpo	អភិរូបោ
abhisaddo	អភិសទ្ទោ
abhisamayo	អភិសមយោ
abhisamayā	អភិសមយា
abhisambodhi	អភិសម្ពោធិ
abhisaṅkhataṃ	អភិសង្ខតំ
abhisaṅkhatā	អភិសង្ខតា
abhissanno	អភិស្សន្នោ
abhitthutaguṇo	អភិត្ថុតគុណោ
abhivaditabbaṃ	អភិវទិតព្ពំ
abhivandisuṃ	អភិវន្ទិសុំ
abhivassanti	អភិវស្សន្តិ
abhivinayetiādīsu	អភិវិនយេតិអាទីសុ
abhivādetvāna	អភិវាទេត្វាន
abhiyācito	អភិយាចិតោ
abhiññatthāya	អភិញ្ញត្ថាយ
abhiññā	អភិញ្ញា
abhiññābala	អភិញ្ញាពល
abhiññābalamāhariṃ	អភិញ្ញាពលមាហរិំ
abhiññābalasampanno	អភិញ្ញាពលសម្បន្នោ
abhiññānañca	អភិញ្ញានញ្ច
abhiññāpāramiṃ	អភិញ្ញាបារមិំ
abhiññāsu	អភិញ្ញាសុ
abhiññātā	អភិញ្ញាតា
abhiññāya	អភិញ្ញាយ
abhiññāyo	អភិញ្ញាយោ
abhiṇhaso	អភិណ្ហសោ
abyākataṃ	អព្យាកតំ
abyākato	អព្យាកតោ
abyākatā	អព្យាកតា
abyākatāti	អព្យាកតាតិ
acalo	អចលោ
acchariyaabbhutadhammappaṭisaṃyuttā	អច្ឆរិយអព្ភុតធម្មប្បដិសំយុត្តា
acchariyā	អច្ឆរិយា
acchariyāni	អច្ឆរិយានិ
acetanabhāvena	អចេតនភាវេន
acinteyyāni	អចិន្តេយ្យានិ
acinteyyānipi	អចិន្តេយ្យានិបិ
ada	អទ
adaṃsu	អទំសុ
addasa	អទ្ទស
addhā	អទ្ធា
addhāne	អទ្ធានេ
adhicittasikkhā	អធិចិត្តសិក្ខា
adhigamanidānadesanānidānasampannassa	អធិគមនិទានទេសនានិទានសម្បន្នស្ស
adhigamanidānañca	អធិគមនិទានញ្ច
adhigamanidānaṃ	អធិគមនិទានំ
adhigantvāva	អធិគន្ត្វាវ
adhigatavisesena	អធិគតវិសេសេន
adhigataṃ	អធិគតំ
adhigato	អធិគតោ
adhigatābhidhammo	អធិគតាភិធម្មោ
adhigañchi	អធិគញ្ឆិ
adhigaṇhitvā	អធិគណ្ហិត្វា
adhike	អធិកេ
adhikāpi	អធិកាបិ
adhikārena	អធិការេន
adhikāro	អធិការោ
adhimattadhitimā	អធិមត្តធិតិមា
adhimattagatimā	អធិមត្តគតិមា
adhimattasatimā	អធិមត្តសតិមា
adhipati	អធិបតិ
adhipatipaccayo	អធិបតិបច្ចយោ
adhipaññāsikkhā	អធិបញ្ញាសិក្ខា
adhippeto	អធិប្បេតោ
adhippāyaṃ	អធិប្បាយំ
adhippāyena	អធិប្បាយេន
adhippāyo	អធិប្បាយោ
adhisīlasikkhā	អធិសីលសិក្ខា
adhivāsentassa	អធិវាសេន្តស្ស
adhivāsesi	អធិវាសេសិ
adhiṭṭhahantassa	អធិដ្ឋហន្តស្ស
adhiṭṭhānapāramitā	អធិដ្ឋានបារមិតា
adhiṭṭhānapāramiṃ	អធិដ្ឋានបារមិំ
adhiṭṭhāne	អធិដ្ឋានេ
adhiṭṭhāniddhi	អធិដ្ឋានិទ្ធិ
adhiṭṭhāya	អធិដ្ឋាយ
adho	អធោ
adhokato	អធោកតោ
adhomukhaṭhapitaudakaghaṭā	អធោមុខឋបិតឧទកឃដា
advejjhamānaso	អទ្វេជ្ឈមានសោ
advejjhavacano	អទ្វេជ្ឈវចនោ
adāsi	អទាសិ
agamāsi	អគមាសិ
aggahesuṃ	អគ្គហេសុំ
aggahetvā	អគ្គហេត្វា
aggahetvāna	អគ្គហេត្វាន
aggaphalasukhanti	អគ្គផលសុខន្តិ
aggaphale	អគ្គផលេ
aggasāvakassa	អគ្គសាវកស្ស
aggasāvakā	អគ្គសាវកា
aggasāvikā	អគ្គសាវិកា
aggaḷadānaṃ	អគ្គឡទានំ
aggidatto	អគ្គិទត្តោ
aggijālaṃ	អគ្គិជាលំ
aggikkhandhova	អគ្គិក្ខន្ធោវ
aggisālāyaṃ	អគ្គិសាលាយំ
aggā	អគ្គា
aggī	អគ្គី
agāmake	អគាមកេ
ahampi	អហម្បិ
ahañhi	អហញ្ហិ
ahaṃ	អហំ
ahesuṃ	អហេសុំ
ahitāya	អហិតាយ
ahosi	អហោសិ
ahosīti	អហោសីតិ
ahu	អហុ
ajapālamucalindarājāyatanesu	អជបាលមុចលិន្ទរាជាយតនេសុ
ajapālanigrodharukkhamūle	អជបាលនិគ្រោធរុក្ខមូលេ
ajaṭākāsaṃ	អជដាកាសំ
ajinacammaṃ	អជិនចម្មំ
ajito	អជិតោ
ajja	អជ្ជ
ajjapetaṃ	អជ្ជបេតំ
ajjhesanaṃ	អជ្ឈេសនំ
ajjhogāhetvā	អជ្ឈោគាហេត្វា
ajjhositabbaṃ	អជ្ឈោសិតព្ពំ
ajjhotthaṭaṃ	អជ្ឈោត្ថដំ
ajjhācārapaṭipakkhabhūto	អជ្ឈាចារបដិបក្ខភូតោ
ajjhāsayaṃ	អជ្ឈាសយំ
ajjunarukkho	អជ្ជុនរុក្ខោ
ajjāpi	អជ្ជាបិ
ajānanasippaṃ	អជាននសិប្បំ
ajānanto	អជានន្តោ
ajānitvāpi	អជានិត្វាបិ
ajātipicchitabbakaṃ	អជាតិបិច្ឆិតព្ពកំ
akathetvā	អកថេត្វា
akatvā	អកត្វា
akilamatthaṃ	អកិលមត្ថំ
akittibrāhmaṇakāle	អកិត្តិព្រាហ្មណកាលេ
akkamittha	អក្កមិត្ថ
akkamitvā	អក្កមិត្វា
akkharāni	អក្ខរានិ
akkhitto	អក្ខិត្តោ
akkhātanti	អក្ខាតន្តិ
akkhātaṃ	អក្ខាតំ
akkhāto	អក្ខាតោ
akkhātoti	អក្ខាតោតិ
akkhīnañca	អក្ខីនញ្ច
akkhīni	អក្ខីនិ
akusalato	អកុសលតោ
akusalavipākato	អកុសលវិបាកតោ
akusalaṃ	អកុសលំ
akusalā	អកុសលា
akāraṇaṃ	អការណំ
akāsi	អកាសិ
alabbhaneyyapatiṭṭhañca	អលព្ភនេយ្យបតិដ្ឋញ្ច
alabbhaneyyapatiṭṭhā	អលព្ភនេយ្យបតិដ្ឋា
alabhiṃ	អលភិំ
alagaddagavesī	អលគទ្ទគវេសី
alagaddapariyesanaṃ	អលគទ្ទបរិយេសនំ
alagaddassa	អលគទ្ទស្ស
alagaddatthiko	អលគទ្ទត្ថិកោ
alagaddaṃ	អលគទ្ទំ
alagaddo	អលគទ្ទោ
alagaddūpamā	អលគទ្ទូបមា
alaṅkatacaṅkamassa	អលង្កតចង្កមស្ស
alaṅkatapaṭiyatto	អលង្កតបដិយត្តោ
alīnasattukumārakāleti	អលីនសត្តុកុមារកាលេតិ
amaccagaṇaparivuto	អមច្ចគណបរិវុតោ
amacco	អមច្ចោ
amakkhetvāva	អមក្ខេត្វាវ
amaravatiyā	អមរវតិយា
amaravatī	អមរវតី
amatantaḷe	អមតន្តឡេ
amatappakāsano	អមតប្បកាសនោ
amatapānaṃ	អមតបានំ
amatassa	អមតស្ស
amataṃ	អមតំ
ambare	អម្ពរេ
amhe	អម្ហេ
amhākaṃ	អម្ហាកំ
amitabhogaṃ	អមិតភោគំ
amitā	អមិតា
amoghavacanā	អមោឃវចនា
anamataggova	អនមតគ្គោវ
anantamaparimāṇaṃ	អនន្តមបរិមាណំ
anantarapaccayo	អនន្តរបច្ចយោ
anantayasaṃ	អនន្តយសំ
anantaṃ	អនន្តំ
ananto	អនន្តោ
anantā	អនន្តា
ananucchavikena	អននុច្ឆវិកេន
anapaloketvā	អនបលោកេត្វា
anapekkhabhāvo	អនបេក្ខភាវោ
anapekkho	អនបេក្ខោ
anapekkhā	អនបេក្ខា
anativattentassa	អនតិវត្តេន្តស្ស
anatthaṅgamiteyeva	អនត្ថង្គមិតេយេវ
anatthiko	អនត្ថិកោ
anatthikā	អនត្ថិកា
anavajjapiṇḍapariyesanabhāvo	អនវជ្ជបិណ្ឌបរិយេសនភាវោ
anavajjasaññī	អនវជ្ជសញ្ញី
anaññātaññassāmītindriyaṃ	អនញ្ញាតញ្ញស្សាមីតិន្ទ្រិយំ
andhakāravelāyaṃ	អន្ធការវេលាយំ
andhakāraṃ	អន្ធការំ
andugharaṃ	អន្ទុឃរំ
andughare	អន្ទុឃរេ
anekajjhāsayānusayacariyādhimuttikā	អនេកជ្ឈាសយានុសយចរិយាធិមុត្តិកា
anekakoṭisatasahassānaṃ	អនេកកោដិសតសហស្សានំ
anekappakāraṃ	អនេកប្បការំ
anekehi	អនេកេហិ
anekesu	អនេកេសុ
anekānusandhikaṃ	អនេកានុសន្ធិកំ
anibbisaṃ	អនិព្ពិសំ
aniccato	អនិច្ចតោ
animisasattāhaṃ	អនិមិសសត្តាហំ
animisehi	អនិមិសេហិ
annapānasamāyutaṃ	អន្នបានសមាយុតំ
annapānena	អន្នបានេន
anojapupphadāmasadisaṃ	អនោជបុប្ផទាមសទិសំ
anomadassī	អនោមទស្សី
anomaṃ	អនោមំ
anomo	អនោមោ
anomā	អនោមា
anomānadītīre	អនោមានទីតីរេ
anotattadahatīre	អនោតត្តទហតីរេ
anotattadahaṃ	អនោតត្តទហំ
anotattadahe	អនោតត្តទហេ
antalikkhe	អន្តលិក្ខេ
antamaso	អន្តមសោ
antarantena	អន្តរន្តេន
antare	អន្តរេ
antarāmagge	អន្តរាមគ្គេ
antarāpatti	អន្តរាបត្តិ
antarāye	អន្តរាយេ
antarāyikā	អន្តរាយិកា
antarāyāyāti	អន្តរាយាយាតិ
antesu	អន្តេសុ
anto	អន្តោ
antopaṇṇasālāyaṃ	អន្តោបណ្ណសាលាយំ
antorukkhatā	អន្តោរុក្ខតា
anubhavamāno	អនុភវមានោ
anubhavanto	អនុភវន្តោ
anucchavikaṃ	អនុច្ឆវិកំ
anucchavikesu	អនុច្ឆវិកេសុ
anuciṇṇaṃ	អនុចិណ្ណំ
anukkamena	អនុក្កមេន
anulomamhi	អនុលោមម្ហិ
anulomapaccanīyamhi	អនុលោមបច្ចនីយម្ហិ
anulomapaccanīye	អនុលោមបច្ចនីយេ
anulomapaccanīyepi	អនុលោមបច្ចនីយេបិ
anulomapaṭilomasaṅkhepavitthārādivasena	អនុលោមបដិលោមសង្ខេបវិត្ថារាទិវសេន
anulomapaṭṭhāne	អនុលោមបដ្ឋានេ
anulome	អនុលោមេ
anulomiko	អនុលោមិកោ
anumodanaṃ	អនុមោទនំ
anumodentānaṃ	អនុមោទេន្តានំ
anumoditakālato	អនុមោទិតកាលតោ
anupacitakusalasambhārehi	អនុបចិតកុសលសម្ភារេហិ
anupadaṃ	អនុបទំ
anupagantvā	អនុបគន្ត្វា
anupakuṭṭho	អនុបកុដ្ឋោ
anupaparikkhataṃ	អនុបបរិក្ខតំ
anupaññattinayā	អនុបញ្ញត្តិនយា
anuppāde	អនុប្បាទេ
anupubbikathaṃ	អនុបុព្ពិកថំ
anupubbikathā	អនុបុព្ពិកថា
anupādāya	អនុបាទាយ
anupāpuṇi	អនុបាបុណិ
anurakkhanto	អនុរក្ខន្តោ
anuruddho	អនុរុទ្ធោ
anusandhivasena	អនុសន្ធិវសេន
anusayapaṭipakkhattā	អនុសយបដិបក្ខត្តា
anusayappahānaṃ	អនុសយប្បហានំ
anusayayamakaṃ	អនុសយយមកំ
anusaṅgītā	អនុសង្គីតា
anussaritvā	អនុស្សរិត្វា
anuttaro	អនុត្តរោ
anuttarā	អនុត្តរា
anuyanti	អនុយន្តិ
anuññātasukhasamphassaattharaṇapāvuraṇādiphassasāmaññato	អនុញ្ញាតសុខសម្ផស្សអត្ថរណបាវុរណាទិផស្សសាមញ្ញតោ
anuḷā	អនុឡា
anāgate	អនាគតេ
anākulaṃ	អនាកុលំ
anāpatti	អនាបត្តិ
apa	អប
apacitidassanatthaṃ	អបចិតិទស្សនត្ថំ
apagatavāḷamigabhiṃsanakasakuṇaṃ	អបគតវាឡមិគភិំសនកសកុណំ
apakkamitvā	អបក្កមិត្វា
aparabhāge	អបរភាគេ
aparaṃ	អបរំ
aparihīnajjhāno	អបរិហីនជ្ឈានោ
aparimāṇo	អបរិមាណោ
aparimāṇoyeva	អបរិមាណោយេវ
aparimāṇā	អបរិមាណា
aparimāṇāva	អបរិមាណាវ
aparituṭṭho	អបរិតុដ្ឋោ
aparānipi	អបរានិបិ
aparāparaṃ	អបរាបរំ
apassanto	អបស្សន្តោ
appagghaṃ	អប្បគ្ឃំ
appamattikāva	អប្បមត្តិកាវ
appamaññāvibhaṅgo	អប្បមញ្ញាវិភង្គោ
appamaññāyo	អប្បមញ្ញាយោ
appameyyo	អប្បមេយ្យោ
appamādena	អប្បមាទេន
appamāṇā	អប្បមាណា
appasamārambhatā	អប្បសមារម្ភតា
appaṭicchādanabhāvo	អប្បដិច្ឆាទនភាវោ
appaṭihatabhāvoti	អប្បដិហតភាវោតិ
appesakkhā	អប្បេសក្ខា
apphoṭenti	អប្ផោដេន្តិ
appicchabhāvo	អប្បិច្ឆភាវោ
appossukkataṃ	អប្បោស្សុក្កតំ
apubbaṃ	អបុព្ពំ
apuññaṃ	អបុញ្ញំ
arahantehi	អរហន្តេហិ
arahanto	អរហន្តោ
arahato	អរហតោ
arahattaṃ	អរហត្តំ
arahatte	អរហត្តេ
arakapaṇḍitakāle	អរកបណ្ឌិតកាលេ
arati	អរតិ
araññaṃ	អរញ្ញំ
araññe	អរញ្ញេ
araṇā	អរណា
arindamo	អរិន្ទមោ
ariyamagge	អរិយមគ្គេ
ariyapariyesana	អរិយបរិយេសន
ariyo	អរិយោ
aruṇavatī	អរុណវតី
aruṇavā	អរុណវា
aruṇuggamanā	អរុណុគ្គមនា
arīhi	អរីហិ
arūpino	អរូបិនោ
arūpāvacarakusalato	អរូបាវចរកុសលតោ
asakkhikaṃ	អសក្ខិកំ
asallakkhentā	អសល្លក្ខេន្តា
asamassa	អសមស្ស
asame	អសមេ
asammaṭṭhampi	អសម្មដ្ឋម្បិ
asammissaṃ	អសម្មិស្សំ
asammohato	អសម្មោហតោ
asamo	អសមោ
asampuṇṇabhāṇavāramattāya	អសម្បុណ្ណភាណវារមត្តាយ
asamā	អសមា
asanarukkho	អសនរុក្ខោ
asanthambhanabhāvo	អសន្ថម្ភនភាវោ
asaññaṃ	អសញ្ញំ
asaṃsaṭṭhabhāvo	អសំសដ្ឋភាវោ
asaṅgahitanti	អសង្គហិតន្តិ
asaṅgahitaṃ	អសង្គហិតំ
asaṅgahitena	អសង្គហិតេន
asaṅgaho	អសង្គហោ
asaṅkhiye	អសង្ខិយេ
asaṅkhiyā	អសង្ខិយា
asaṅkhyeyyaṃ	អសង្ខ្យេយ្យំ
asaṅkhyeyyo	អសង្ខ្យេយ្យោ
asaṅkhyeyyānaṃ	អសង្ខ្យេយ្យានំ
asaṅkhyeyyāni	អសង្ខ្យេយ្យានិ
asekkhā	អសេក្ខា
asesato	អសេសតោ
asoko	អសោកោ
asokā	អសោកា
assamapadaṃ	អស្សមបទំ
assamapaṇṇasālācaṅkamā	អស្សមបណ្ណសាលាចង្កមា
assamaṃ	អស្សមំ
assame	អស្សមេ
assamo	អស្សមោ
assaratanaṃ	អស្សរតនំ
assasaddaṃ	អស្សសទ្ទំ
assatthoti	អស្សត្ថោតិ
assāti	អស្សាតិ
asucimpi	អសុចិម្បិ
asuciṃ	អសុចិំ
asukassa	អសុកស្ស
asāruppabhāvo	អសារុប្បភាវោ
asītibhikkhusahassāni	អសីតិភិក្ខុសហស្សានិ
asītihatthamatte	អសីតិហត្ថមត្តេ
asītihatthappamāṇāyeva	អសីតិហត្ថប្បមាណាយេវ
asītihatthubbedhaṃ	អសីតិហត្ថុព្ពេធំ
asītikoṭidhanaṃ	អសីតិកោដិធនំ
asītikoṭisahassāni	អសីតិកោដិសហស្សានិ
asītikoṭiyo	អសីតិកោដិយោ
asītisahassāni	អសីតិសហស្សានិ
asītivassasahassāni	អសីតិវស្សសហស្សានិ
atha	អថ
athassa	អថស្ស
atibrahmāti	អតិព្រហ្មាតិ
aticchattanti	អតិច្ឆត្តន្តិ
atidevo	អតិទេវោ
atidevoti	អតិទេវោតិ
atidhajoti	អតិធជោតិ
atidhāvanto	អតិធាវន្តោ
atikkamitvā	អតិក្កមិត្វា
atikkamma	អតិក្កម្ម
atikkante	អតិក្កន្តេ
atirekabhāṇavāramatto	អតិរេកភាណវារមត្តោ
atirekabhāṇavāro	អតិរេកភាណវារោ
atirekachabhāṇavāramattaṃ	អតិរេកឆភាណវារមត្តំ
atirekachabhāṇavāraṃ	អតិរេកឆភាណវារំ
atirekadvibhāṇavāramatto	អតិរេកទ្វិភាណវារមត្តោ
atirekadvibhāṇavāraṃ	អតិរេកទ្វិភាណវារំ
atirekapañcabhāṇavārā	អតិរេកបញ្ចភាណវារា
atirekappamāṇaṃ	អតិរេកប្បមាណំ
atirekappamāṇo	អតិរេកប្បមាណោ
atirekataro	អតិរេកតរោ
atirekatarā	អតិរេកតរា
atirekaterasamattabhāṇavāraṃ	អតិរេកតេរសមត្តភាណវារំ
atirocati	អតិរោចតិ
atirājakumāroti	អតិរាជកុមារោតិ
atisambādhatā	អតិសម្ពាធតា
ativisālatā	អតិវិសាលតា
ativisālatāti	អតិវិសាលតាតិ
ativiya	អតិវិយ
attabhāve	អត្តភាវេ
attano	អត្តនោ
attanā	អត្តនា
attapariccāgaṃ	អត្តបរិច្ចាគំ
attatthaparatthādibhede	អត្តត្ថបរត្ថាទិភេទេ
atthadassī	អត្ថទស្សី
atthajotanā	អត្ថជោតនា
atthajātaṃ	អត្ថជាតំ
atthapaṭisambhidāti	អត្ថបដិសម្ភិទាតិ
atthassa	អត្ថស្ស
atthato	អត្ថតោ
atthaṃ	អត្ថំ
atthe	អត្ថេ
atthesu	អត្ថេសុ
atthi	អត្ថិ
atthibhāvampi	អត្ថិភាវម្បិ
atthibhāvo	អត្ថិភាវោ
atthipaccayo	អត្ថិបច្ចយោ
attho	អត្ថោ
atthoti	អត្ថោតិ
atthuddhārabhūtaṃ	អត្ថុទ្ធារភូតំ
atthuddhāroti	អត្ថុទ្ធារោតិ
atthā	អត្ថា
atthānurūpaṃ	អត្ថានុរូបំ
atthīti	អត្ថីតិ
attānañca	អត្តានញ្ច
attānaṃ	អត្តានំ
atulo	អតុលោ
avabodho	អវពោធោ
avakujjo	អវកុជ្ជោ
avasesaṃ	អវសេសំ
avasesā	អវសេសា
avatvā	អវត្វា
avedi	អវេទិ
avelāya	អវេលាយ
avidūrenidānakathā	អវិទូរេនិទានកថា
avidūrenidānaṃ	អវិទូរេនិទានំ
avigatapaccayoti	អវិគតបច្ចយោតិ
avijjā	អវិជ្ជា
avijjābhāgino	អវិជ្ជាភាគិនោ
avijjāya	អវិជ្ជាយ
aviparītasabhāvo	អវិបរីតសភាវោ
aviparītāvabodhasaṅkhāto	អវិបរីតាវពោធសង្ខាតោ
avisayo	អវិសយោ
avisiṭṭhaṃ	អវិសិដ្ឋំ
avivittaṃ	អវិវិត្តំ
aviññāya	អវិញ្ញាយ
ayamassa	អយមស្ស
ayampi	អយម្បិ
ayamānubhāvo	អយមានុភាវោ
ayañca	អយញ្ច
ayañhi	អយញ្ហិ
ayaṃ	អយំ
ayogharapaṇḍitakāleti	អយោឃរបណ្ឌិតកាលេតិ
ayya	អយ្យ
ayyakapayyakānaṃ	អយ្យកបយ្យកានំ
ayyāti	អយ្យាតិ
añjaliṃ	អញ្ជលិំ
añjanacuṇṇasamokiṇṇaṃ	អញ្ជនចុណ្ណសមោកិណ្ណំ
añjanādibhesajjāni	អញ្ជនាទិភេសជ្ជានិ
añjasassa	អញ្ជសស្ស
añjasaṃ	អញ្ជសំ
añjitaakkhīni	អញ្ជិតអក្ខីនិ
aññamaññapaccayo	អញ្ញមញ្ញបច្ចយោ
aññamaññasaṅkaravirahite	អញ្ញមញ្ញសង្ករវិរហិតេ
aññamaññassa	អញ្ញមញ្ញស្ស
aññamaññaṃ	អញ្ញមញ្ញំ
aññampi	អញ្ញម្បិ
aññatarasmiṃ	អញ្ញតរស្មិំ
aññathattaṃ	អញ្ញថត្តំ
aññathā	អញ្ញថា
aññatra	អញ្ញត្រ
aññaṃ	អញ្ញំ
aññe	អញ្ញេ
aññena	អញ្ញេន
aññesaṃ	អញ្ញេសំ
añño	អញ្ញោ
aññāsikoṇḍaññattherappamukhā	អញ្ញាសិកោណ្ឌញ្ញត្ថេរប្បមុខា
aññātavesena	អញ្ញាតវេសេន
aḍḍaṃ	អឌ្ឌំ
aḍḍhachakkesu	អឌ្ឍឆក្កេសុ
aḍḍharatanike	អឌ្ឍរតនិកេ
aṃse	អំសេ
aṅgapaccaṅge	អង្គបច្ចង្គេ
aṅgato	អង្គតោ
aṅgavasena	អង្គវសេន
aṅgehi	អង្គេហិ
aṅguliyopi	អង្គុលិយោបិ
aṅguttaranikāyo	អង្គុត្តរនិកាយោ
aṅguttare	អង្គុត្តរេ
aṅgārakapalladāruādīnīti	អង្គារកបល្លទារុអាទីនីតិ
aṅkusakapacchitidaṇḍakādīni	អង្កុសកបច្ឆិតិទណ្ឌកាទីនិ
aṭṭha	អដ្ឋ
aṭṭhadosasamākiṇṇaṃ	អដ្ឋទោសសមាកិណ្ណំ
aṭṭhaguṇasamupetaṃ	អដ្ឋគុណសមុបេតំ
aṭṭhahi	អដ្ឋហិ
aṭṭhakathākaṇḍaṃ	អដ្ឋកថាកណ្ឌំ
aṭṭhakathāya	អដ្ឋកថាយ
aṭṭhamaṃ	អដ្ឋមំ
aṭṭhame	អដ្ឋមេ
aṭṭhamo	អដ្ឋមោ
aṭṭhamoti	អដ្ឋមោតិ
aṭṭhamukhā	អដ្ឋមុខា
aṭṭhanahutādhikacatuyojanasatasahassabahalaṃ	អដ្ឋនហុតាធិកចតុយោជនសតសហស្សពហលំ
aṭṭhanavutibhikkhusatasahassāni	អដ្ឋនវុតិភិក្ខុសតសហស្សានិ
aṭṭhapaṇṇāsahatthubbedhaṃ	អដ្ឋបណ្ណាសហត្ថុព្ពេធំ
aṭṭhasaṭṭhibhikkhusatasahassāni	អដ្ឋសដ្ឋិភិក្ខុសតសហស្សានិ
aṭṭhasu	អដ្ឋសុ
aṭṭhatiṇamuṭṭhiṃ	អដ្ឋតិណមុដ្ឋិំ
aṭṭhaṅgiko	អដ្ឋង្គិកោ
aṭṭhānaṃ	អដ្ឋានំ
aṭṭhārasa	អដ្ឋារស
aṭṭhārasakappasataccayena	អដ្ឋារសកប្បសតច្ចយេន
aṭṭhārasakappasatamatthake	អដ្ឋារសកប្បសតមត្ថកេ
aṭṭhārasasu	អដ្ឋារសសុ
aṭṭhārasavassādhikānaṃ	អដ្ឋារសវស្សាធិកានំ
aṭṭhārasavassādhikāni	អដ្ឋារសវស្សាធិកានិ
aṭṭhārasavidhena	អដ្ឋារសវិធេន
aṭṭhāsi	អដ្ឋាសិ
aṭṭhāsītihatthubbedhaṃ	អដ្ឋាសីតិហត្ថុព្ពេធំ
aṭṭhāsītisahassāni	អដ្ឋាសីតិសហស្សានិ
baddhaṃ	ពទ្ធំ
bahussuto	ពហុស្សុតោ
bahusādhāraṇabhāvo	ពហុសាធារណភាវោ
bahusādhāraṇagehe	ពហុសាធារណគេហេ
bahuñca	ពហុញ្ច
bahuṃ	ពហុំ
bahū	ពហូ
bahūpakārataṃ	ពហូបការតំ
bahūsu	ពហូសុ
balabojjhaṅgakammavipākantaraṃ	ពលពោជ្ឈង្គកម្មវិបាកន្តរំ
balavabhāvaṃ	ពលវភាវំ
balavanti	ពលវន្តិ
balavapaccūse	ពលវបច្ចូសេ
balavapīti	ពលវបីតិ
balavataraṃ	ពលវតរំ
balavā	ពលវា
balaṃ	ពលំ
bandhanaṃ	ពន្ធនំ
bandhati	ពន្ធតិ
bandhumatī	ពន្ធុមតី
bandhumā	ពន្ធុមា
beluvapakkavaṇṇā	ពេលុវបក្កវណ្ណា
bhaddaji	ភទ្ទជិ
bhaddanāmo	ភទ្ទនាមោ
bhaddasālo	ភទ្ទសាលោ
bhaddo	ភទ្ទោ
bhaddā	ភទ្ទា
bhadrayobbanaṃ	ភទ្រយោព្ពនំ
bhagavantaṃyeva	ភគវន្តំយេវ
bhagavato	ភគវតោ
bhagavatā	ភគវតា
bhagavatātiādinayappavattā	ភគវតាតិអាទិនយប្បវត្តា
bhagavā	ភគវា
bhaggā	ភគ្គា
bhante	ភន្តេ
bhanteti	ភន្តេតិ
bhantā	ភន្តា
bhatiyā	ភតិយា
bhatiṃ	ភតិំ
bhattakiccaṃ	ភត្តកិច្ចំ
bhattānumodanakālepi	ភត្តានុមោទនកាលេបិ
bhava	ភវ
bhavanaṃ	ភវនំ
bhavanti	ភវន្តិ
bhavantvantarāyā	ភវន្ត្វន្តរាយា
bhavati	ភវតិ
bhavato	ភវតោ
bhavaṃ	ភវំ
bhavaṅgaparivāso	ភវង្គបរិវាសោ
bhave	ភវេ
bhaveyyanti	ភវេយ្យន្តិ
bhaveyyāti	ភវេយ្យាតិ
bhavissantīti	ភវិស្សន្តីតិ
bhavissare	ភវិស្សរេ
bhavissasi	ភវិស្សសិ
bhavissasīti	ភវិស្សសីតិ
bhavissati	ភវិស្សតិ
bhavissatīti	ភវិស្សតីតិ
bhavissāmi	ភវិស្សាមិ
bhavābhave	ភវាភវេ
bhavāmahaṃ	ភវាមហំ
bhaṇati	ភណតិ
bhaṇḍamādiya	ភណ្ឌមាទិយ
bhaṇḍāgārikapariyattī	ភណ្ឌាគារិកបរិយត្តី
bhaṇḍāgārikapariyattīti	ភណ្ឌាគារិកបរិយត្តីតិ
bhedakaravatthūsu	ភេទករវត្ថូសុ
bhedanaṃ	ភេទនំ
bherisaṅkharathāni	ភេរិសង្ខរថានិ
bheriyo	ភេរិយោ
bheriṃ	ភេរិំ
bhesajjatthāya	ភេសជ្ជត្ថាយ
bhijjantīti	ភិជ្ជន្តីតិ
bhikkhanto	ភិក្ខន្តោ
bhikkhave	ភិក្ខវេ
bhikkhavoti	ភិក្ខវោតិ
bhikkhaṃ	ភិក្ខំ
bhikkhu	ភិក្ខុ
bhikkhunā	ភិក្ខុនា
bhikkhusahassamajjhe	ភិក្ខុសហស្សមជ្ឈេ
bhikkhusatasahassaṃ	ភិក្ខុសតសហស្សំ
bhikkhusatasahassāni	ភិក្ខុសតសហស្សានិ
bhikkhusatānaṃ	ភិក្ខុសតានំ
bhikkhusaṅghassa	ភិក្ខុសង្ឃស្ស
bhikkhusaṅghaṃ	ភិក្ខុសង្ឃំ
bhikkhusaṅghepi	ភិក្ខុសង្ឃេបិ
bhikkhusaṅgho	ភិក្ខុសង្ឃោ
bhikkhuto	ភិក្ខុតោ
bhikkhācāravelaṃ	ភិក្ខាចារវេលំ
bhikkhāya	ភិក្ខាយ
bhikkhū	ភិក្ខូ
bhikkhūhi	ភិក្ខូហិ
bhikkhūnaṃ	ភិក្ខូនំ
bhikkhūsu	ភិក្ខូសុ
bhikkhūti	ភិក្ខូតិ
bhindissāmi	ភិន្ទិស្សាមិ
bhinditvā	ភិន្ទិត្វា
bhittiyaṃ	ភិត្តិយំ
bhiyyo	ភិយ្យោ
bhiyyoso	ភិយ្យោសោ
bho	ភោ
bhoge	ភោគេ
bhojanaṃ	ភោជនំ
bhojayitvāna	ភោជយិត្វាន
bhusavātehi	ភុសវាតេហិ
bhāgī	ភាគី
bhājanampi	ភាជនម្បិ
bhājanato	ភាជនតោ
bhājessatīti	ភាជេស្សតីតិ
bhāradvājo	ភារទ្វាជោ
bhāramoropanaṃ	ភារមោរោបនំ
bhāsamānassa	ភាសមានស្ស
bhāsaṃ	ភាសំ
bhāsitaṃ	ភាសិតំ
bhāsitoti	ភាសិតោតិ
bhāsāya	ភាសាយ
bhātha	ភាថ
bhāvanāmayiddhi	ភាវនាមយិទ្ធិ
bhāvaya	ភាវយ
bhāveti	ភាវេតិ
bhāvitamaggo	ភាវិតមគ្គោ
bhāvitatto	ភាវិតត្តោ
bhāyāmi	ភាយាមិ
bhītā	ភីតា
bhūmantaraparicchedo	ភូមន្តរបរិច្ឆេទោ
bhūmaṭṭhā	ភូមដ្ឋា
bhūmi	ភូមិ
bhūmitalagatā	ភូមិតលគតា
bhūmito	ភូមិតោ
bhūmiyañceva	ភូមិយញ្ចេវ
bhūmiyaṃ	ភូមិយំ
bhūmiyā	ភូមិយា
bhūmīsu	ភូមីសុ
bhūridattanāgarājakāle	ភូរិទត្តនាគរាជកាលេ
bidalamañcakapasse	ពិទលមញ្ចកបស្សេ
bidalamañcako	ពិទលមញ្ចកោ
bimbijālotipi	ពិម្ពិជាលោតិបិ
bodheti	ពោធេតិ
bodhi	ពោធិ
bodhiabhinīhārasaddhāya	ពោធិអភិនីហារសទ្ធាយ
bodhimaṇḍamhi	ពោធិមណ្ឌម្ហិ
bodhimaṇḍaṃ	ពោធិមណ្ឌំ
bodhimaṇḍe	ពោធិមណ្ឌេ
bodhimaṇḍā	ពោធិមណ្ឌា
bodhimuttamaṃ	ពោធិមុត្តមំ
bodhimūlamupehiti	ពោធិមូលមុបេហិតិ
bodhimūle	ពោធិមូលេ
bodhiparibbājakakāle	ពោធិបរិព្ពាជកកាលេ
bodhipācanā	ពោធិបាចនា
bodhisattacariyakāle	ពោធិសត្តចរិយកាលេ
bodhisattakāle	ពោធិសត្តកាលេ
bodhisattassa	ពោធិសត្តស្ស
bodhisattaṃ	ពោធិសត្តំ
bodhisatto	ពោធិសត្តោ
bodhisattānaṃ	ពោធិសត្តានំ
bodhiyā	ពោធិយា
bodhiṃ	ពោធិំ
bojjhaṅgavibhaṅgo	ពោជ្ឈង្គវិភង្គោ
bojjhaṅgā	ពោជ្ឈង្គា
brahmabhūto	ព្រហ្មភូតោ
brahmadevo	ព្រហ្មទេវោ
brahmaghosaṃ	ព្រហ្មឃោសំ
brahmajālādīni	ព្រហ្មជាលាទីនិ
brahmakoṭiyo	ព្រហ្មកោដិយោ
brahmaloke	ព្រហ្មលោកេ
brahmassaraṃ	ព្រហ្មស្សរំ
brahmuno	ព្រហ្មុនោ
brahmāpi	ព្រហ្មាបិ
brāhmaṇamāṇavo	ព្រាហ្មណមាណវោ
brāhmaṇasippameva	ព្រាហ្មណសិប្បមេវ
brāhmaṇassa	ព្រាហ្មណស្ស
brāhmaṇavaṇṇena	ព្រាហ្មណវណ្ណេន
brāhmaṇaṃ	ព្រាហ្មណំ
brāhmaṇo	ព្រាហ្មណោ
brāhmaṇī	ព្រាហ្មណី
bu	ពុ
buddhabhāsitameva	ពុទ្ធភាសិតមេវ
buddhabhāsitaṃ	ពុទ្ធភាសិតំ
buddhabhāsito	ពុទ្ធភាសិតោ
buddhabhāsitoti	ពុទ្ធភាសិតោតិ
buddhabhāsitānīti	ពុទ្ធភាសិតានីតិ
buddhabhāvatthāya	ពុទ្ធភាវត្ថាយ
buddhabhāvaṃ	ពុទ្ធភាវំ
buddhabhūmiṃ	ពុទ្ធភូមិំ
buddhabhūtassa	ពុទ្ធភូតស្ស
buddhabījaṃ	ពុទ្ធពីជំ
buddhacakkhunā	ពុទ្ធចក្ខុនា
buddhadhammā	ពុទ្ធធម្មា
buddhaghosena	ពុទ្ធឃោសេន
buddhaguṇaṃ	ពុទ្ធគុណំ
buddhakare	ពុទ្ធករេ
buddhakarā	ពុទ្ធករា
buddhameva	ពុទ្ធមេវ
buddhantaraṃ	ពុទ្ធន្តរំ
buddhapaccekabuddhādīhi	ពុទ្ធបច្ចេកពុទ្ធាទីហិ
buddhappamukhassa	ពុទ្ធប្បមុខស្ស
buddhappamukhaṃ	ពុទ្ធប្បមុខំ
buddharasmīhiyeva	ពុទ្ធរស្មីហិយេវ
buddharatane	ពុទ្ធរតនេ
buddhaseṭṭhānaṃ	ពុទ្ធសេដ្ឋានំ
buddhassa	ពុទ្ធស្ស
buddhasāsanaṃ	ពុទ្ធសាសនំ
buddhato	ពុទ្ធតោ
buddhavacananti	ពុទ្ធវចនន្តិ
buddhavacanassa	ពុទ្ធវចនស្ស
buddhavacanaṃ	ពុទ្ធវចនំ
buddhavaṃse	ពុទ្ធវំសេ
buddhañāṇena	ពុទ្ធញាណេន
buddhena	ពុទ្ធេន
buddhijo	ពុទ្ធិជោ
buddho	ពុទ្ធោ
buddhoti	ពុទ្ធោតិ
buddhā	ពុទ្ធា
buddhālokeneva	ពុទ្ធាលោកេនេវ
buddhānameva	ពុទ្ធានមេវ
buddhānaṃ	ពុទ្ធានំ
buddhārammaṇaṃ	ពុទ្ធារម្មណំ
budhaṃ	ពុធំ
bujjhante	ពុជ្ឈន្តេ
bujjhare	ពុជ្ឈរេ
bujjhassu	ពុជ្ឈស្សុ
bujjhissati	ពុជ្ឈិស្សតិ
byapagataṃ	ព្យបគតំ
byādhidhammo	ព្យាធិធម្មោ
byādhito	ព្យាធិតោ
byādhiṃ	ព្យាធិំ
byākaramāno	ព្យាករមានោ
byākaraṇaṃ	ព្យាករណំ
byākareyya	ព្យាករេយ្យ
byākareyyaṃ	ព្យាករេយ្យំ
byākaritvā	ព្យាករិត្វា
byākaroti	ព្យាករោតិ
byākatanti	ព្យាកតន្តិ
byākāsi	ព្យាកាសិ
byākāsiṃ	ព្យាកាសិំ
byāmappabhā	ព្យាមប្បភា
byāthitamānasā	ព្យាថិតមានសា
bāhujaññaṃ	ពាហុជញ្ញំ
bāhā	ពាហា
bāhāya	ពាហាយ
bārāṇasī	ពារាណសី
bāvīsatindriyāni	ពាវីសតិន្ទ្រិយានិ
bāḷhā	ពាឡ្ហា
bījāni	ពីជានិ
ca	ច
cajitvā	ចជិត្វា
cakkaratanaṃ	ចក្ករតនំ
cakkaratanāni	ចក្ករតនានិ
cakkavattirañño	ចក្កវត្តិរញ្ញោ
cakkavattirājā	ចក្កវត្តិរាជា
cakkavattī	ចក្កវត្តី
cakkavāḷapabbatena	ចក្កវាឡបព្ពតេន
cakkaṃ	ចក្កំ
cakkhubhūto	ចក្ខុភូតោ
cakkhuma	ចក្ខុម
cakkhūhi	ចក្ខូហិ
camarī	ចមរី
cammakaṃ	ចម្មកំ
campakarukkho	ចម្បករុក្ខោ
campakaṃ	ចម្បកំ
campeyyanāgarājakāle	ចម្បេយ្យនាគរាជកាលេ
campā	ចម្បា
candakumārakāle	ចន្ទកុមារកាលេ
candamhi	ចន្ទម្ហិ
candamittā	ចន្ទមិត្តា
candanacuṇṇañca	ចន្ទនចុណ្ណញ្ច
candanavanaṃ	ចន្ទនវនំ
candappabhā	ចន្ទប្បភា
candavatī	ចន្ទវតី
candimasūriyādayo	ចន្ទិមសូរិយាទយោ
candimāyuttā	ចន្ទិមាយុត្តា
cando	ចន្ទោ
candā	ចន្ទា
caramāno	ចរមានោ
carantassa	ចរន្តស្ស
caraṇo	ចរណោ
carituṃ	ចរិតុំ
caritvā	ចរិត្វា
cariyā	ចរិយា
cariyābhiññā	ចរិយាភិញ្ញា
cariyāpiṭakato	ចរិយាបិដកតោ
carāpetvā	ចរាបេត្វា
cassa	ចស្ស
catasso	ចតស្សោ
catthāya	ចត្ថាយ
cattālīsabhikkhusahassāni	ចត្តាលីសភិក្ខុសហស្សានិ
cattālīsahatthubbedhaṃ	ចត្តាលីសហត្ថុព្ពេធំ
cattālīsavassasahassāni	ចត្តាលីសវស្សសហស្សានិ
cattālīsaṃ	ចត្តាលីសំ
cattāri	ចត្តារិ
cattārimāni	ចត្តារិមានិ
cattāro	ចត្តារោ
cattārome	ចត្តារោមេ
cattārīti	ចត្តារីតិ
catubbidho	ចតុព្ពិធោ
catubbidhopi	ចតុព្ពិធោបិ
catumahādīparajjaṃ	ចតុមហាទីបរជ្ជំ
catunavutikappamatthake	ចតុនវុតិកប្បមត្ថកេ
catunnaṃ	ចតុន្នំ
catuparisamajjhe	ចតុបរិសមជ្ឈេ
caturo	ចតុរោ
caturoghaniddharaṇatthaṃ	ចតុរោឃនិទ្ធរណត្ថំ
caturopete	ចតុរោបេតេ
caturāsīti	ចតុរាសីតិ
caturāsītidhammakkhandhasahassāni	ចតុរាសីតិធម្មក្ខន្ធសហស្សានិ
caturāsītisahassappabhedaṃ	ចតុរាសីតិសហស្សប្បភេទំ
caturāsītiyojanasahassagambhīre	ចតុរាសីតិយោជនសហស្សគម្ភីរេ
caturāsītiyojanasahassagambhīro	ចតុរាសីតិយោជនសហស្សគម្ភីរោ
caturāsītiyojanasahassamatthake	ចតុរាសីតិយោជនសហស្សមត្ថកេ
catutthavāre	ចតុត្ថវារេ
catutthaṃ	ចតុត្ថំ
catutthe	ចតុត្ថេ
catuttho	ចតុត្ថោ
catuttiṃsa	ចតុត្តិំស
catuvīsatippabhede	ចតុវីសតិប្បភេទេ
catuvīsatisamantapaṭṭhānasamodhānaṃ	ចតុវីសតិសមន្តបដ្ឋានសមោធានំ
catuvīsatisamantapaṭṭhānaṃ	ចតុវីសតិសមន្តបដ្ឋានំ
catuvīsatividhena	ចតុវីសតិវិធេន
catuvīsatiyā	ចតុវីសតិយា
catūsu	ចតូសុ
cavitvā	ចវិត្វា
cañjaliṃ	ចញ្ជលិំ
caṅkamadosā	ចង្កមទោសា
caṅkamakoṭiṃ	ចង្កមកោដិំ
caṅkamanakoṭiyaṃ	ចង្កមនកោដិយំ
caṅkamanasattāhañca	ចង្កមនសត្តាហញ្ច
caṅkamanaṃ	ចង្កមនំ
caṅkamantassa	ចង្កមន្តស្ស
caṅkamanto	ចង្កមន្តោ
caṅkamavemajjhe	ចង្កមវេមជ្ឈេ
caṅkamañca	ចង្កមញ្ច
caṅkamaṃ	ចង្កមំ
caṅkame	ចង្កមេ
caṅkami	ចង្កមិ
ce	ចេ
cepi	ចេបិ
cesa	ចេស
cetaso	ចេតសោ
cetasā	ចេតសា
cetaṃ	ចេតំ
cetesu	ចេតេសុ
cetiyagirimhi	ចេតិយគិរិម្ហិ
cetiyaṃ	ចេតិយំ
cettha	ចេត្ថ
cetāni	ចេតានិ
ceva	ចេវ
cha	ឆ
chabbassāni	ឆព្ពស្សានិ
chabbaṇṇarasmiyo	ឆព្ពណ្ណរស្មិយោ
chabbidhena	ឆព្ពិធេន
chaddantanāgarājakāle	ឆទ្ទន្តនាគរាជកាលេ
chahi	ឆហិ
chamattabhāṇavāro	ឆមត្តភាណវារោ
chandatā	ឆន្ទតា
channasahāyova	ឆន្នសហាយោវ
channaṃ	ឆន្នំ
chappakaraṇāni	ឆប្បករណានិ
chattaṃ	ឆត្តំ
chattesu	ឆត្តេសុ
chavaṭṭhikaṃ	ឆវដ្ឋិកំ
chavivaṇṇo	ឆវិវណ្ណោ
chaḍḍayitvāna	ឆឌ្ឌយិត្វាន
chaḍḍayiṃ	ឆឌ្ឌយិំ
chaḍḍetha	ឆឌ្ឌេថ
chaḍḍetvā	ឆឌ្ឌេត្វា
chaḷabhiññehi	ឆឡភិញ្ញេហិ
chaḷabhiññā	ឆឡភិញ្ញា
chaṭṭhamaṃ	ឆដ្ឋមំ
chaṭṭho	ឆដ្ឋោ
chindissāmīti	ឆិន្ទិស្សាមីតិ
chinditvā	ឆិន្ទិត្វា
chuddhā	ឆុទ្ធា
cikkhallikanikāyoti	ចិក្ខល្លិកនិកាយោតិ
cintayato	ចិន្តយតោ
cintayitvāna	ចិន្តយិត្វាន
cintento	ចិន្តេន្តោ
cintesahaṃ	ចិន្តេសហំ
cintesi	ចិន្តេសិ
cintetabbāni	ចិន្តេតព្ពានិ
cinteti	ចិន្តេតិ
cintetvā	ចិន្តេត្វា
cintitadhammaṃ	ចិន្តិតធម្មំ
cintā	ចិន្តា
ciravuttho	ចិរវុត្ថោ
cirāyanti	ចិរាយន្តិ
cito	ចិតោ
citoti	ចិតោតិ
cittakkhepaṃ	ចិត្តក្ខេបំ
cittapariyādānādīni	ចិត្តបរិយាទានាទីនិ
cittassa	ចិត្តស្ស
cittavibhatti	ចិត្តវិភត្តិ
cittavārabhājanaṃ	ចិត្តវារភាជនំ
cittayamakaṃ	ចិត្តយមកំ
cittaṃ	ចិត្តំ
cittekaggatā	ចិត្តេកគ្គតា
cittena	ចិត្តេន
cittāni	ចិត្តានិ
cittīkārapītibahulo	ចិត្តីការបីតិពហុលោ
ciṇṇavasī	ចិណ្ណវសី
coravilope	ចោរវិលោបេ
corehi	ចោរេហិ
cuddasavidhena	ចុទ្ទសវិធេន
cuto	ចុតោ
cutā	ចុតា
cutūpapātañāṇaṃ	ចុតូបបាតញាណំ
cāgaṃ	ចាគំ
cālā	ចាលា
cāpi	ចាបិ
cāti	ចាតិ
cātumahārājadattiyaṃ	ចាតុមហារាជទត្តិយំ
cātumahārājike	ចាតុមហារាជិកេ
cāvetukāmoti	ចាវេតុកាមោតិ
cāyaṃ	ចាយំ
cīnapiṭṭhacuṇṇarañjitā	ចីនបិដ្ឋចុណ្ណរញ្ជិតា
cīvaraggahaṇaṃ	ចីវរគ្គហណំ
cīvarapaccaye	ចីវរបច្ចយេ
cīvaravaṃse	ចីវរវំសេ
cīvaraṃ	ចីវរំ
cūḷasutasomajātakāle	ចូឡសុតសោមជាតកាលេ
cūḷāya	ចូឡាយ
dadamānasseva	ទទមានស្សេវ
dadamāno	ទទមានោ
dadamānā	ទទមានា
dadantassa	ទទន្តស្ស
dadāmi	ទទាមិ
dadātha	ទទាថ
daharakāleyeva	ទហរកាលេយេវ
dakajā	ទកជា
dakkhiṇahatthaṃ	ទក្ខិណហត្ថំ
dakkhiṇaṃ	ទក្ខិណំ
dakkhiṇena	ទក្ខិណេន
dantehi	ទន្តេហិ
dantāvaraṇaṃ	ទន្តាវរណំ
darīsayā	ទរីសយា
dasa	ទស
dasabalacatuvesārajjādisabbabuddhaguṇapaṭimaṇḍitaṃ	ទសពលចតុវេសារជ្ជាទិសព្ពពុទ្ធគុណបដិមណ្ឌិតំ
dasabalassa	ទសពលស្ស
dasabalena	ទសពលេន
dasacakkavāḷasahassāni	ទសចក្កវាឡសហស្សានិ
dasahi	ទសហិ
dasahupāgata	ទសហុបាគត
dasahupāgataṃ	ទសហុបាគតំ
dasahāgamma	ទសហាគម្ម
dasamaṃ	ទសមំ
dasamo	ទសមោ
dasamoti	ទសមោតិ
dasapāramī	ទសបារមី
dasasahassacakkavāḷadevatānaṃ	ទសសហស្សចក្កវាឡទេវតានំ
dasasahasse	ទសសហស្សេ
dasasahassilokadhātudevatāhi	ទសសហស្សិលោកធាតុទេវតាហិ
dasasahassilokadhātuṃ	ទសសហស្សិលោកធាតុំ
dasasahassimahābrahmaparivārena	ទសសហស្សិមហាព្រហ្មបរិវារេន
dasasahassiyaṃ	ទសសហស្សិយំ
dasasahassiṃ	ទសសហស្សិំ
dasasahassādhivāsino	ទសសហស្សាធិវាសិនោ
dasasahassī	ទសសហស្សី
dasasahassīnacūbhayaṃ	ទសសហស្សីនចូភយំ
dasavaggapariggaho	ទសវគ្គបរិគ្គហោ
dasavidhe	ទសវិធេ
dasavidhena	ទសវិធេន
dasindriyā	ទសិន្ទ្រិយា
dassaneyyaṃ	ទស្សនេយ្យំ
dassanīyo	ទស្សនីយោ
dassentassa	ទស្សេន្តស្ស
dassentena	ទស្សេន្តេន
dassenti	ទស្សេន្តិ
dassesi	ទស្សេសិ
dassetuṃ	ទស្សេតុំ
dassitasamuddasadisaṃ	ទស្សិតសមុទ្ទសទិសំ
dassitaṃ	ទស្សិតំ
dassitā	ទស្សិតា
dassāmīti	ទស្សាមីតិ
dasuttarasatasuttantā	ទសុត្តរសតសុត្តន្តា
dasuttarasuttantehi	ទសុត្តរសុត្តន្តេហិ
dasāyatanā	ទសាយតនា
datvā	ទត្វា
datvāna	ទត្វាន
daḷhaṃ	ទឡ្ហំ
daḷho	ទឡ្ហោ
daḷhīkammasithilakaraṇappayojanā	ទឡ្ហីកម្មសិថិលករណប្បយោជនា
daṇḍakadīpikāveṭhananiyāmena	ទណ្ឌកទីបិកាវេឋននិយាមេន
daṭṭhabbo	ទដ្ឋព្ពោ
daṭṭho	ទដ្ឋោ
dehīti	ទេហីតិ
dente	ទេន្តេ
denti	ទេន្តិ
desanā	ទេសនា
desanānidānañca	ទេសនានិទានញ្ច
desanānidānaṃ	ទេសនានិទានំ
desaṃ	ទេសំ
desentassa	ទេសេន្តស្ស
desento	ទេសេន្តោ
desentova	ទេសេន្តោវ
desentānaṃ	ទេសេន្តានំ
desesi	ទេសេសិ
desetabbadesanā	ទេសេតព្ពទេសនា
deseti	ទេសេតិ
desetuṃ	ទេសេតុំ
desetvā	ទេសេត្វា
desetūti	ទេសេតូតិ
deseyyanti	ទេសេយ្យន្តិ
desitabhāvo	ទេសិតភាវោ
desitadesanaṃ	ទេសិតទេសនំ
desitadhammo	ទេសិតធម្មោ
desitadhammopi	ទេសិតធម្មោបិ
desitattā	ទេសិតត្តា
desitaṃ	ទេសិតំ
desito	ទេសិតោ
desitoti	ទេសិតោតិ
desitā	ទេសិតា
desitāti	ទេសិតាតិ
dessaṃ	ទេស្សំ
dessā	ទេស្សា
deti	ទេតិ
deva	ទេវ
devabhavanamhi	ទេវភវនម្ហិ
devadevo	ទេវទេវោ
devadūte	ទេវទូតេ
devalo	ទេវលោ
devalokameva	ទេវលោកមេវ
devalokasiriṃ	ទេវលោកសិរិំ
devalokato	ទេវលោកតោ
devalokaṃ	ទេវលោកំ
devaloke	ទេវលោកេ
devamanussā	ទេវមនុស្សា
devanagaraṃva	ទេវនគរំវ
devaputtena	ទេវបុត្តេន
devarañño	ទេវរញ្ញោ
devaraññā	ទេវរញ្ញា
devarājā	ទេវរាជា
devasikaṃ	ទេវសិកំ
devatā	ទេវតា
devatāhi	ទេវតាហិ
devatānaṃ	ទេវតានំ
deve	ទេវេ
devehi	ទេវេហិ
devesu	ទេវេសុ
devo	ទេវោ
devorohanaṃ	ទេវោរោហនំ
devā	ទេវា
devānamindo	ទេវានមិន្ទោ
devānaṃ	ទេវានំ
devāpi	ទេវាបិ
devāsane	ទេវាសនេ
dha	ធ
dhajesu	ធជេសុ
dhajo	ធជោ
dhammabhūto	ធម្មភូតោ
dhammacakkappavattanaṃ	ធម្មចក្កប្បវត្តនំ
dhammacakkappavattanā	ធម្មចក្កប្បវត្តនា
dhammacakkaṃ	ធម្មចក្កំ
dhammacintaṃ	ធម្មចិន្តំ
dhammacāriṃ	ធម្មចារិំ
dhammacārīti	ធម្មចារីតិ
dhammadassī	ធម្មទស្សី
dhammadesanavelā	ធម្មទេសនវេលា
dhammadesanaṃ	ធម្មទេសនំ
dhammadesane	ធម្មទេសនេ
dhammadesayi	ធម្មទេសយិ
dhammadhātuyañca	ធម្មធាតុយញ្ច
dhammadhātuyā	ធម្មធាតុយា
dhammadinnā	ធម្មទិន្នា
dhammagambhīratāpaccavekkhaṇena	ធម្មគម្ភីរតាបច្ចវេក្ខណេន
dhammahadayavibhaṅgoti	ធម្មហទយវិភង្គោតិ
dhammajātaṃ	ធម្មជាតំ
dhammakathaṃ	ធម្មកថំ
dhammakathika	ធម្មកថិក
dhammakathikoti	ធម្មកថិកោតិ
dhammakathikā	ធម្មកថិកា
dhammakkhandhagaṇanā	ធម្មក្ខន្ធគណនា
dhammakkhandhasahassāni	ធម្មក្ខន្ធសហស្សានិ
dhammakkhandhasahassānīti	ធម្មក្ខន្ធសហស្សានីតិ
dhammakkhandhato	ធម្មក្ខន្ធតោ
dhammakkhandho	ធម្មក្ខន្ធោ
dhammakkhandhoti	ធម្មក្ខន្ធោតិ
dhammantaraṃ	ធម្មន្តរំ
dhammantarā	ធម្មន្តរា
dhammapadesoti	ធម្មបទេសោតិ
dhammapadādayo	ធម្មបទាទយោ
dhammapaṭisambhidāti	ធម្មបដិសម្ភិទាតិ
dhammapuñjamatte	ធម្មបុញ្ជមត្តេ
dhammasavanatthāya	ធម្មសវនត្ថាយ
dhammasaṅgaṇiṃ	ធម្មសង្គណិំ
dhammasaṅgaṇīpakaraṇaṃ	ធម្មសង្គណីបករណំ
dhammasaṅgaṇīpakaraṇe	ធម្មសង្គណីបករណេ
dhammasaṅgaṇīvibhaṅgadhātukathāpuggalapaññattikathāvatthuyamakapaṭṭhānānaṃ	ធម្មសង្គណីវិភង្គធាតុកថាបុគ្គលបញ្ញត្តិកថាវត្ថុយមកបដ្ឋានានំ
dhammaseno	ធម្មសេនោ
dhammasenāpati	ធម្មសេនាបតិ
dhammassāmī	ធម្មស្សាមី
dhammato	ធម្មតោ
dhammatthadesanāpaṭivedhagambhīrabhāvo	ធម្មត្ថទេសនាបដិវេធគម្ភីរភាវោ
dhammatthadesanāpaṭivedhā	ធម្មត្ថទេសនាបដិវេធា
dhammayamakaṃ	ធម្មយមកំ
dhammaṃ	ធម្មំ
dhamme	ធម្មេ
dhammesu	ធម្មេសុ
dhammikaanavajjabhāvo	ធម្មិកអនវជ្ជភាវោ
dhammikapabbataṃ	ធម្មិកបព្ពតំ
dhammikapabbate	ធម្មិកបព្ពតេ
dhammiko	ធម្មិកោ
dhammiyo	ធម្មិយោ
dhammo	ធម្មោ
dhammā	ធម្មា
dhammābhilāpoti	ធម្មាភិលាបោតិ
dhammābhisamayo	ធម្មាភិសមយោ
dhammānanti	ធម្មានន្តិ
dhammānaṃ	ធម្មានំ
dhammānurūpaṃ	ធម្មានុរូបំ
dhammāpe	ធម្មាបេ
dhammāti	ធម្មាតិ
dhammātirekadhammavisesaṭṭhena	ធម្មាតិរេកធម្មវិសេសដ្ឋេន
dhammātiādinā	ធម្មាតិអាទិនា
dhammāyatane	ធម្មាយតនេ
dhammī	ធម្មី
dhanadhaññapariggahābhāvo	ធនធញ្ញបរិគ្គហាភាវោ
dhanasāraṃ	ធនសារំ
dhanavatī	ធនវតី
dhanañcayarājakāle	ធនញ្ចយរាជកាលេ
dhanaṃ	ធនំ
dhaññanibbattakaṃ	ធញ្ញនិព្ពត្តកំ
dhaññavatī	ធញ្ញវតី
dhaññaṃ	ធញ្ញំ
dhenu	ធេនុ
dhovitabbo	ធោវិតព្ពោ
dhoviyamānepi	ធោវិយមានេបិ
dhovāpetvā	ធោវាបេត្វា
dhuragāme	ធុរគាមេ
dhuvasassataṃ	ធុវសស្សតំ
dhuvassavaṃ	ធុវស្សវំ
dhuvaṃ	ធុវំ
dhārayantesu	ធារយន្តេសុ
dhāraṇe	ធារណេ
dhārenti	ធារេន្តិ
dhārentī	ធារេន្តី
dhāretuṃ	ធារេតុំ
dhāreyyāthāti	ធារេយ្យាថាតិ
dhārito	ធារិតោ
dhātukathaṃ	ធាតុកថំ
dhātukathāpakaraṇaṃ	ធាតុកថាបករណំ
dhātupadeso	ធាតុបទេសោ
dhātupaññatti	ធាតុបញ្ញត្តិ
dhātuvibhaṅgo	ធាតុវិភង្គោ
dhātuyamakaṃ	ធាតុយមកំ
dhātuyo	ធាតុយោ
dhātuāyatanāna	ធាតុអាយតនាន
dhātvantaraṃ	ធាត្វន្តរំ
dhīrapurisehi	ធីរបុរិសេហិ
dibbacakkhunā	ទិព្ពចក្ខុនា
dibbagandhapupphehi	ទិព្ពគន្ធបុប្ផេហិ
dibbagandho	ទិព្ពគន្ធោ
dibbamandāravapadumapāricchattakapupphāni	ទិព្ពមន្ទារវបទុមបារិច្ឆត្តកបុប្ផានិ
dibbasampattiṃ	ទិព្ពសម្បត្តិំ
dibbatūriyehi	ទិព្ពតូរិយេហិ
dibbehi	ទិព្ពេហិ
dibbā	ទិព្ពា
dinnakāle	ទិន្នកាលេ
dinnanayena	ទិន្ននយេន
dinnaṃ	ទិន្នំ
disaṃ	ទិសំ
dissanti	ទិស្សន្តិ
dissati	ទិស្សតិ
disvā	ទិស្វា
disvāna	ទិស្វាន
disvāpi	ទិស្វាបិ
disā	ទិសា
disābhāgā	ទិសាភាគា
disāsu	ទិសាសុ
disāya	ទិសាយ
divasabhāgaṃ	ទិវសភាគំ
divasehi	ទិវសេហិ
divasesu	ទិវសេសុ
divāvihāraṃ	ទិវាវិហារំ
divāvihārāya	ទិវាវិហារាយ
diyaḍḍhakilesasahassaṃ	ទិយឌ្ឍកិលេសសហស្សំ
diyaḍḍharatanaṃ	ទិយឌ្ឍរតនំ
diyaḍḍhasataṃ	ទិយឌ្ឍសតំ
diṭṭhiviniveṭhanakathā	ទិដ្ឋិវិនិវេឋនកថា
diṭṭhiviniveṭhanā	ទិដ្ឋិវិនិវេឋនា
diṭṭhosi	ទិដ្ឋោសិ
diṭṭhā	ទិដ្ឋា
domanassaṃ	ទោមនស្សំ
domanassindriyaṃ	ទោមនស្សិន្ទ្រិយំ
dose	ទោសេ
doso	ទោសោ
dosoti	ទោសោតិ
dosā	ទោសា
dosānurūpaṃ	ទោសានុរូបំ
duccaritasaṃkilesassa	ទុច្ចរិតសំកិលេសស្ស
duggahitattā	ទុគ្គហិតត្តា
duggahitaṃ	ទុគ្គហិតំ
duggahitena	ទុគ្គហិតេន
duggahitā	ទុគ្គហិតា
duggatiṃ	ទុគ្គតិំ
dukadukapaṭṭhānaṃ	ទុកទុកបដ្ឋានំ
dukadukañca	ទុកទុកញ្ច
dukamātikā	ទុកមាតិកា
dukapaṭṭhānaṃ	ទុកបដ្ឋានំ
dukasataṃ	ទុកសតំ
dukasate	ទុកសតេ
dukatikapaṭṭhānaṃ	ទុកតិកបដ្ឋានំ
duke	ទុកេ
dukesuyeva	ទុកេសុយេវ
dukhaṃ	ទុខំ
dukhaṭṭito	ទុខដ្ដិតោ
dukhā	ទុខា
dukkarakārikaṃ	ទុក្ករការិកំ
dukkathitaṃ	ទុក្កថិតំ
dukkhasaccaṃ	ទុក្ខសច្ចំ
dukkhasacce	ទុក្ខសច្ចេ
dukkhassa	ទុក្ខស្ស
dukkhato	ទុក្ខតោ
dukkhaṃ	ទុក្ខំ
dukkhe	ទុក្ខេ
dukkhito	ទុក្ខិតោ
dukkhogāhaṃ	ទុក្ខោគាហំ
dukkhogāhā	ទុក្ខោគាហា
dukkhā	ទុក្ខា
dukkhāya	ទុក្ខាយ
dukuttamaṃ	ទុកុត្តមំ
dukā	ទុកា
dukāti	ទុកាតិ
dullabhā	ទុល្លភា
dumā	ទុមា
duppaññehi	ទុប្បញ្ញេហិ
duppaṭipanno	ទុប្បដិបន្នោ
durabhisambhavabhāvo	ទុរភិសម្ភវភាវោ
dussayugāni	ទុស្សយុគានិ
dussīlabhāvamicchādiṭṭhitācittakkhepappabhedaṃ	ទុស្សីលភាវមិច្ឆាទិដ្ឋិតាចិត្តក្ខេបប្បភេទំ
dussīlabhāvaṃ	ទុស្សីលភាវំ
dutiyakavāso	ទុតិយកវាសោ
dutiyaṃ	ទុតិយំ
dutiye	ទុតិយេ
dutiyo	ទុតិយោ
duvidhatthena	ទុវិធត្ថេន
duvidhenātiādinā	ទុវិធេនាតិអាទិនា
dvattiṃsa	ទ្វត្តិំស
dve	ទ្វេ
dvenavutikappamatthake	ទ្វេនវុតិកប្បមត្ថកេ
dvepi	ទ្វេបិ
dvibhāṇavāramatto	ទ្វិភាណវារមត្តោ
dvimattabhāṇavāraṃ	ទ្វិមត្តភាណវារំ
dvimattabhāṇavāro	ទ្វិមត្តភាណវារោ
dvinnaṃ	ទ្វិន្នំ
dvācattālīsa	ទ្វាចត្តាលីស
dvādasa	ទ្វាទស
dvādasaguṇamupāgataṃ	ទ្វាទសគុណមុបាគតំ
dvādasahi	ទ្វាទសហិ
dvādasamoti	ទ្វាទសមោតិ
dvādasapadiko	ទ្វាទសបទិកោ
dvādasayojane	ទ្វាទសយោជនេ
dvādasānisaṃsā	ទ្វាទសានិសំសា
dvādasāyatanāni	ទ្វាទសាយតនានិ
dvārato	ទ្វារតោ
dvāsaṭṭhi	ទ្វាសដ្ឋិ
dvāsaṭṭhidiṭṭhipaṭipakkhabhūtā	ទ្វាសដ្ឋិទិដ្ឋិបដិបក្ខភូតា
dvāsīti	ទ្វាសីតិ
dvāvīsati	ទ្វាវីសតិ
dvāvīsatitike	ទ្វាវីសតិតិកេ
dvāvīsatiyā	ទ្វាវីសតិយា
dvīsu	ទ្វីសុ
dāmā	ទាមា
dāmāni	ទាមានិ
dānabalā	ទានពលា
dānajjhāsayataṃ	ទានជ្ឈាសយតំ
dānanti	ទានន្តិ
dānapāraminti	ទានបារមិន្តិ
dānapāramitā	ទានបារមិតា
dānapāramitādayo	ទានបារមិតាទយោ
dānapāramitāya	ទានបារមិតាយ
dānapāramiṃ	ទានបារមិំ
dānapāramīti	ទានបារមីតិ
dānaṃ	ទានំ
dāni	ទានិ
dārake	ទារកេ
dāsako	ទាសកោ
dātuṃ	ទាតុំ
dātā	ទាតា
dī	ទី
dīghamaddhānaṃ	ទីឃមទ្ធានំ
dīghamajjhimanikāyappamāṇā	ទីឃមជ្ឈិមនិកាយប្បមាណា
dīghanikāyappamāṇaṃ	ទីឃនិកាយប្បមាណំ
dīghanikāyo	ទីឃនិកាយោ
dīghanikāyope	ទីឃនិកាយោបេ
dīghanikāyoti	ទីឃនិកាយោតិ
dīgharattaṃ	ទីឃរត្តំ
dīghasuttaṃ	ទីឃសុត្តំ
dīghato	ទីឃតោ
dīghaādike	ទីឃអាទិកេ
dīpappasādakamahāmahindattherassa	ទីបប្បសាទកមហាមហិន្ទត្ថេរស្ស
dīparukkhova	ទីបរុក្ខោវ
dīpavāsīnaṃ	ទីបវាសីនំ
dīpayanto	ទីបយន្តោ
dīpaṃ	ទីបំ
dīpaṅkaradasabalato	ទីបង្ករទសពលតោ
dīpaṅkaramupāgamuṃ	ទីបង្ករមុបាគមុំ
dīpaṅkarapādamūlato	ទីបង្ករបាទមូលតោ
dīpaṅkarapādamūle	ទីបង្ករបាទមូលេ
dīpaṅkarasanāmako	ទីបង្ករសនាមកោ
dīpaṅkarassa	ទីបង្ករស្ស
dīpaṅkaro	ទីបង្ករោ
dīpaṅkarādīnaṃ	ទីបង្ករាទីនំ
dīpeti	ទីបេតិ
dūrenidānaṃ	ទូរេនិទានំ
ehi	ឯហិ
ekadeseneva	ឯកទេសេនេវ
ekadivasaṃyeva	ឯកទិវសំយេវ
ekadivasepi	ឯកទិវសេបិ
ekaggataṃ	ឯកគ្គតំ
ekakahāpaṇampi	ឯកកហាបណម្បិ
ekakato	ឯកកតោ
ekamantaṃ	ឯកមន្តំ
ekamekasmiṃ	ឯកមេកស្មិំ
ekamekañca	ឯកមេកញ្ច
ekamekaṃ	ឯកមេកំ
ekameko	ឯកមេកោ
ekameva	ឯកមេវ
ekanavutikappe	ឯកនវុតិកប្បេ
ekandhakārāni	ឯកន្ធការានិ
ekanikāyampi	ឯកនិកាយម្បិ
ekanipātadukanipātasaṅgīti	ឯកនិបាតទុកនិបាតសង្គីតិ
ekantadhammakathiko	ឯកន្តធម្មកថិកោ
ekantarikā	ឯកន្តរិកា
ekantato	ឯកន្តតោ
ekapallaṅkena	ឯកបល្លង្កេន
ekappahāreneva	ឯកប្បហារេនេវ
ekasatasahassaṃ	ឯកសតសហស្សំ
ekasataṃ	ឯកសតំ
ekasmiṃ	ឯកស្មិំ
ekasmiṃyeva	ឯកស្មិំយេវ
ekassa	ឯកស្ស
ekatiṃsakappe	ឯកតិំសកប្បេ
ekatiṃse	ឯកតិំសេ
ekato	ឯកតោ
ekavidhena	ឯកវិធេន
ekavīsatiyā	ឯកវីសតិយា
ekaṃ	ឯកំ
ekaṃsaṃ	ឯកំសំ
ekekā	ឯកេកា
ekena	ឯកេន
ekissā	ឯកិស្សា
eko	ឯកោ
ekokāsaṃ	ឯកោកាសំ
ekoti	ឯកោតិ
ekova	ឯកោវ
ekādasa	ឯកាទស
ekādasamo	ឯកាទសមោ
ekānusandhikaṃ	ឯកានុសន្ធិកំ
ekūnanavuti	ឯកូននវុតិ
esa	ឯស
esantassa	ឯសន្តស្ស
eseva	ឯសេវ
esevanto	ឯសេវន្តោ
eso	ឯសោ
esā	ឯសា
etadahosi	ឯតទហោសិ
etamatthaṃ	ឯតមត្ថំ
etassa	ឯតស្ស
etasseva	ឯតស្សេវ
etaṃ	ឯតំ
ete	ឯតេ
eteheva	ឯតេហេវ
etena	ឯតេន
eteneva	ឯតេនេវ
etesu	ឯតេសុ
etha	ឯថ
ettakampi	ឯត្តកម្បិ
ettakaṃ	ឯត្តកំ
ettake	ឯត្តកេ
ettakenapi	ឯត្តកេនបិ
ettako	ឯត្តកោ
ettakā	ឯត្តកា
ettakānañhi	ឯត្តកានញ្ហិ
ettakānaṃ	ឯត្តកានំ
ettakāni	ឯត្តកានិ
ettakāyeva	ឯត្តកាយេវ
ettha	ឯត្ថ
etthāyaṃ	ឯត្ថាយំ
etto	ឯត្តោ
etāni	ឯតានិ
eva	ឯវ
evamassāpi	ឯវមស្សាបិ
evametampi	ឯវមេតម្បិ
evamete	ឯវមេតេ
evametena	ឯវមេតេន
evameva	ឯវមេវ
evamevaṃ	ឯវមេវំ
evamādīhi	ឯវមាទីហិ
evamāha	ឯវមាហ
evarūpaṃ	ឯវរូបំ
evarūpe	ឯវរូបេ
evarūpena	ឯវរូបេន
evarūpo	ឯវរូបោ
evaṃ	ឯវំ
gabbhe	គព្ភេ
gaccha	គច្ឆ
gacchantaṃ	គច្ឆន្តំ
gacchanti	គច្ឆន្តិ
gacchanto	គច្ឆន្តោ
gacchantā	គច្ឆន្តា
gacchati	គច្ឆតិ
gacchatu	គច្ឆតុ
gacchatīti	គច្ឆតីតិ
gaccheyya	គច្ឆេយ្យ
gaccheyyaṃ	គច្ឆេយ្យំ
gacchissaṃ	គច្ឆិស្សំ
gacchāmi	គច្ឆាមិ
gaganamaṇḍale	គគនមណ្ឌលេ
gaganatalaṃ	គគនតលំ
gaganatale	គគនតលេ
gaganā	គគនា
gahakūṭaṃ	គហកូដំ
gahanacchannatā	គហនច្ឆន្នតា
gahetabbo	គហេតព្ពោ
gahetuṃ	គហេតុំ
gahetvā	គហេត្វា
gahetvāna	គហេត្វាន
gahitapaṭiñño	គហិតបដិញ្ញោ
gahitaṃ	គហិតំ
gamanakāraṇaṃ	គមនការណំ
gamanampathe	គមនម្បថេ
gamanasamaye	គមនសមយេ
gambhīrabhāvavijānanatthaṃ	គម្ភីរភាវវិជាននត្ថំ
gambhīrabhāvo	គម្ភីរភាវោ
gambhīragataṃ	គម្ភីរគតំ
gambhīrañāṇehi	គម្ភីរញាណេហិ
gambhīraṃ	គម្ភីរំ
gambhīrā	គម្ភីរា
gamissāmi	គមិស្សាមិ
gandhabbā	គន្ធព្ពា
gandhadāmamālādāmāni	គន្ធទាមមាលាទាមានិ
gandho	គន្ធោ
ganthentena	គន្ថេន្តេន
ganthetvā	គន្ថេត្វា
gantvā	គន្ត្វា
garahapaṭicchādanabhāvo	គរហបដិច្ឆាទនភាវោ
garahaṃ	គរហំ
garahitā	គរហិតា
garahāya	គរហាយ
gatagataṭṭhāne	គតគតដ្ឋានេ
gate	គតេ
gato	គតោ
gatā	គតា
gavapānaṃ	គវបានំ
gavesantassa	គវេសន្តស្ស
gavesanto	គវេសន្តោ
gavesati	គវេសតិ
gaṇanacāraṃ	គណនចារំ
gaṇanacāropi	គណនចារោបិ
gaṇanā	គណនា
gaṇanāto	គណនាតោ
gaṇena	គណេន
gaṇhantesu	គណ្ហន្តេសុ
gaṇhanti	គណ្ហន្តិ
gaṇhanto	គណ្ហន្តោ
gaṇhatha	គណ្ហថ
gaṇhathāti	គណ្ហថាតិ
gaṇheyya	គណ្ហេយ្យ
gaṇheyyātha	គណ្ហេយ្យាថ
gaṇhi	គណ្ហិ
gaṇhitthāti	គណ្ហិត្ថាតិ
gaṇhituṃ	គណ្ហិតុំ
gaṇhiṃ	គណ្ហិំ
gaṇhiṃsu	គណ្ហិំសុ
gaṇhāti	គណ្ហាតិ
gehasampadā	គេហសម្បទា
gehassa	គេហស្ស
gehaṃ	គេហំ
gehālayapaṭikkhepo	គេហាលយបដិក្ខេបោ
geyya	គេយ្យ
geyyaṃ	គេយ្យំ
ghanakkhandho	ឃនក្ខន្ធោ
ghanamahāpathaviṃ	ឃនមហាបថវិំ
ghanapākapakke	ឃនបាកបក្កេ
gharāvāsaṃ	ឃរាវាសំ
gharāvāse	ឃរាវាសេ
gharāvāsena	ឃរាវាសេន
ghaṭakā	ឃដកា
ghaṭento	ឃដេន្តោ
ghaṭikārassa	ឃដិការស្ស
ghositaṃ	ឃោសិតំ
gihibandhanaṃ	គិហិពន្ធនំ
girikandarānusārena	គិរិកន្ទរានុសារេន
gocarāya	គោចរាយ
gopetabbo	គោបេតព្ពោ
gosiṅgasālavanaṃ	គោសិង្គសាលវនំ
gotamo	គោតមោ
guṇasampatti	គុណសម្បត្តិ
guṇaṃ	គុណំ
guṇe	គុណេ
guṇehi	គុណេហិ
guṇo	គុណោ
guṇā	គុណា
gāhāpetvā	គាហាបេត្វា
gāmadārakesu	គាមទារកេសុ
gāmaṃ	គាមំ
gāthaṃ	គាថំ
gāthā	គាថា
gāthāsahassāni	គាថាសហស្សានិ
gāthāyo	គាថាយោ
gīvato	គីវតោ
gīvaṃ	គីវំ
gūthagato	គូថគតោ
hadayamaṃsaṃ	ហទយមំសំ
handa	ហន្ទ
hasanti	ហសន្តិ
hatthagataṃ	ហត្ថគតំ
hatthaṃ	ហត្ថំ
hatthe	ហត្ថេ
hatthena	ហត្ថេន
hatthippamāṇaṃ	ហត្ថិប្បមាណំ
hatthipālakumārakāle	ហត្ថិបាលកុមារកាលេ
hatthiratanaṃ	ហត្ថិរតនំ
hatthāḷavako	ហត្ថាឡវកោ
hatā	ហតា
have	ហវេ
haṃsavatī	ហំសវតី
haṭṭhapahaṭṭho	ហដ្ឋបហដ្ឋោ
hehiti	ហេហិតិ
hesa	ហេស
hessanti	ហេស្សន្តិ
hessantupaṭṭhakā	ហេស្សន្តុបដ្ឋកា
hessantupaṭṭhikā	ហេស្សន្តុបដ្ឋិកា
hessati	ហេស្សតិ
hessaṃ	ហេស្សំ
hessāma	ហេស្សាម
hetaṃ	ហេតំ
hete	ហេតេ
hettha	ហេត្ថ
hetu	ហេតុ
hetumhi	ហេតុម្ហិ
hetupaccayo	ហេតុបច្ចយោ
hetuphalaṃ	ហេតុផលំ
hetuphale	ហេតុផលេ
hetuye	ហេតុយេ
hetū	ហេតូ
heṭṭhā	ហេដ្ឋា
heṭṭhālohapāsāde	ហេដ្ឋាលោហបាសាទេ
hi	ហិ
hidaṃ	ហិទំ
himavantamupāgamiṃ	ហិមវន្តមុបាគមិំ
himavantapāde	ហិមវន្តបាទេ
himavantaṃ	ហិមវន្តំ
hitāhite	ហិតាហិតេ
hitāya	ហិតាយ
hohi	ហោហិ
homi	ហោមិ
honti	ហោន្តិ
hontāvaraṇā	ហោន្តាវរណា
hotha	ហោថ
hoti	ហោតិ
hotiyeva	ហោតិយេវ
hotu	ហោតុ
hotīti	ហោតីតិ
hotītiādinā	ហោតីតិអាទិនា
hutvā	ហុត្វា
hāso	ហាសោ
hāvuso	ហាវុសោ
hīnamukkaṭṭhamajjhime	ហីនមុក្កដ្ឋមជ្ឈិមេ
hīraṃ	ហីរំ
icchitabbakaṃ	ឥច្ឆិតព្ពកំ
icchitabbako	ឥច្ឆិតព្ពកោ
idamassa	ឥទមស្ស
idaṃ	ឥទំ
iddhaṃ	ឥទ្ធំ
iddhi	ឥទ្ធិ
iddhidhammesu	ឥទ្ធិធម្មេសុ
iddhimayapattacīvaradharā	ឥទ្ធិមយបត្តចីវរធរា
iddhimayapattacīvarassa	ឥទ្ធិមយបត្តចីវរស្ស
iddhipādabojjhaṅgamaggaṅgavibhaṅgā	ឥទ្ធិបាទពោជ្ឈង្គមគ្គង្គវិភង្គា
iddhipādavibhaṅgo	ឥទ្ធិបាទវិភង្គោ
iddhipādā	ឥទ្ធិបាទា
idhekacce	ឥធេកច្ចេ
idhāgatāti	ឥធាគតាតិ
idhāvuso	ឥធាវុសោ
idriyavibhaṅgo	ឥទ្រិយវិភង្គោ
idāni	ឥទានិ
imameva	ឥមមេវ
imasmiṃ	ឥមស្មិំ
imasmā	ឥមស្មា
imassa	ឥមស្ស
imaṃ	ឥមំ
ime	ឥមេ
imesaṃ	ឥមេសំ
imesu	ឥមេសុ
iminā	ឥមិនា
imināva	ឥមិនាវ
imissā	ឥមិស្សា
imāni	ឥមានិ
imāya	ឥមាយ
indriyantaraṃ	ឥន្ទ្រិយន្តរំ
indriyapaccayo	ឥន្ទ្រិយបច្ចយោ
indriyapadeso	ឥន្ទ្រិយបទេសោ
indriyapaññatti	ឥន្ទ្រិយបញ្ញត្តិ
indriyavibhaṅge	ឥន្ទ្រិយវិភង្គេ
indriyayamakanti	ឥន្ទ្រិយយមកន្តិ
indriyāni	ឥន្ទ្រិយានិ
isayo	ឥសយោ
isipabbajjaṃ	ឥសិបព្ពជ្ជំ
isipatane	ឥសិបតនេ
isīhi	ឥសីហិ
itaresu	ឥតរេសុ
iti	ឥតិ
itihāse	ឥតិហាសេ
itivu	ឥតិវុ
itivuttaka	ឥតិវុត្តក
itivuttakaṃ	ឥតិវុត្តកំ
itivādappamokkhānisaṃsā	ឥតិវាទប្បមោក្ខានិសំសា
ito	ឥតោ
itopi	ឥតោបិ
iṅgha	ឥង្ឃ
iṭṭiyo	ឥដ្ដិយោ
jaccandhā	ជច្ចន្ធា
jahanti	ជហន្តិ
jajjaraṃ	ជជ្ជរំ
jalamajjhe	ជលមជ្ឈេ
jalasāgaro	ជលសាគរោ
jambudīpatale	ជម្ពុទីបតលេ
janakāyaṃ	ជនកាយំ
janasandho	ជនសន្ធោ
janataṃ	ជនតំ
janaṃ	ជនំ
jane	ជនេ
janesi	ជនេសិ
janeti	ជនេតិ
janettiyā	ជនេត្តិយា
janikā	ជនិកា
jarādhammo	ជរាធម្មោ
jayaddisarājaputtakāle	ជយទ្ទិសរាជបុត្តកាលេ
jayaseno	ជយសេនោ
jayasumanapāribhaddakabandhujīvakakusumasamparikiṇṇā	ជយសុមនបារិភទ្ទកពន្ធុជីវកកុសុមសម្បរិកិណ្ណា
jaṭilaṃ	ជដិលំ
jaṭilo	ជដិលោ
jaṭāmaṇḍalavākacīratidaṇḍakuṇḍikādike	ជដាមណ្ឌលវាកចីរតិទណ្ឌកុណ្ឌិកាទិកេ
jaṭāmaṇḍalaṃ	ជដាមណ្ឌលំ
jhānapaccayo	ឈានបច្ចយោ
jhānapadeso	ឈានបទេសោ
jhānaratisamappito	ឈានរតិសមប្បិតោ
jhānavibhaṅgo	ឈានវិភង្គោ
jhānaṅgesu	ឈានង្គេសុ
jhāne	ឈានេ
jhānāni	ឈានានិ
jhāpaye	ឈាបយេ
jhāyato	ឈាយតោ
jighacchā	ជិឃច្ឆា
jigucchiya	ជិគុច្ឆិយ
jinabodhiyaṃ	ជិនពោធិយំ
jinacakke	ជិនចក្កេ
jinaputtā	ជិនបុត្តា
jinasevitaṃ	ជិនសេវិតំ
jinavacanabhūtā	ជិនវចនភូតា
jinaṃ	ជិនំ
jine	ជិនេ
jino	ជិនោ
jinā	ជិនា
jitamitto	ជិតមិត្តោ
jivhā	ជិវ្ហា
jiṇṇabyādhimatasaṅkhāte	ជិណ្ណព្យាធិមតសង្ខាតេ
jiṇṇanāvaṃva	ជិណ្ណនាវំវ
jiṇṇassa	ជិណ្ណស្ស
jiṇṇepi	ជិណ្ណេបិ
jotanti	ជោតន្តិ
jotipālo	ជោតិបាលោ
jā	ជា
jālāpetvā	ជាលាបេត្វា
jānanti	ជានន្តិ
jānantīti	ជានន្តីតិ
jānaṃ	ជានំ
jānissāmīti	ជានិស្សាមីតិ
jānitunti	ជានិតុន្តិ
jānituṃ	ជានិតុំ
jānāma	ជានាម
jānāmīti	ជានាមីតិ
jānāsīti	ជានាសីតិ
jānāti	ជានាតិ
jānātīti	ជានាតីតិ
jātaka	ជាតក
jātakasatesu	ជាតកសតេសុ
jātakasatāni	ជាតកសតានិ
jātakasuttanipātadhammapadādīnaṃ	ជាតកសុត្តនិបាតធម្មបទាទីនំ
jātakaṃ	ជាតកំ
jātanagaraṃ	ជាតនគរំ
jātasāsanaṃ	ជាតសាសនំ
jātaṃ	ជាតំ
jāti	ជាតិ
jātibhogayasaissariyādisampattīhi	ជាតិភោគយសឥស្សរិយាទិសម្បត្តីហិ
jātivādena	ជាតិវាទេន
jātā	ជាតា
jāyante	ជាយន្តេ
jīraṇabhāvo	ជីរណភាវោ
jīvissasīti	ជីវិស្សសីតិ
jīvitapariccāgaṃ	ជីវិតបរិច្ចាគំ
jīvitaṃ	ជីវិតំ
kabaḷīkārāhārappaṭibaddhaṃ	កពឡីការាហារប្បដិពទ្ធំ
kacchehi	កច្ឆេហិ
kaccānenāti	កច្ចានេនាតិ
kakudharukkhotipi	កកុធរុក្ខោតិបិ
kakusandho	កកុសន្ធោ
kalale	កលលេ
kalyāṇamapi	កល្យាណមបិ
kalyāṇamatha	កល្យាណមថ
kalyāṇe	កល្យាណេ
kammakiriyadassanā	កម្មកិរិយទស្សនា
kammantaraṃ	កម្មន្តរំ
kammapaccayo	កម្មបច្ចយោ
kammassa	កម្មស្ស
kammaṃ	កម្មំ
kammaṭṭhānaṃ	កម្មដ្ឋានំ
kammākammaṃ	កម្មាកម្មំ
kampati	កម្បតិ
kampento	កម្បេន្តោ
kampi	កម្បិ
kampitā	កម្បិតា
kandanto	កន្ទន្តោ
kapilavhayā	កបិលវ្ហយា
kapotapādavaṇṇaṃ	កបោតបាទវណ្ណំ
kappakavesaṃ	កប្បកវេសំ
kappakoṭisatehipi	កប្បកោដិសតេហិបិ
kappasahassānaṃ	កប្បសហស្សានំ
kappasatasahassādhikānaṃ	កប្បសតសហស្សាធិកានំ
kappasatasahassādhikāni	កប្បសតសហស្សាធិកានិ
kappasatasahassānaṃ	កប្បសតសហស្សានំ
kappasatānaṃ	កប្បសតានំ
kappe	កប្បេ
kappemi	កប្បេមិ
kappiyabhaṇḍaṃ	កប្បិយភណ្ឌំ
kappiyanti	កប្បិយន្តិ
kappiyaparikkhārā	កប្បិយបរិក្ខារា
kappāsapacchiyaṃ	កប្បាសបច្ឆិយំ
karaṇabhāvo	ករណភាវោ
karaṇapariyesanabhāvo	ករណបរិយេសនភាវោ
kareyyaṃ	ករេយ្យំ
karissasīti	ករិស្សសីតិ
karissāmatthavaṇṇanaṃ	ករិស្សាមត្ថវណ្ណនំ
karissāmi	ករិស្សាមិ
karissāmīti	ករិស្សាមីតិ
karontassa	ករោន្តស្ស
karonto	ករោន្តោ
karosīti	ករោសីតិ
karoti	ករោតិ
karīsaṃ	ករីសំ
kasiṇamaṇḍalaṃ	កសិណមណ្ឌលំ
kasiṇaparikammaṃ	កសិណបរិកម្មំ
kasmā	កស្មា
kassa	កស្ស
kassaci	កស្សចិ
kassapadasabalassa	កស្សបទសពលស្ស
kassapo	កស្សបោ
katamo	កតមោ
katanti	កតន្តិ
kataparivāro	កតបរិវារោ
katapāṭihāriyañca	កតបាដិហារិយញ្ច
katasanniṭṭhāno	កតសន្និដ្ឋានោ
katassa	កតស្ស
katayamakapāṭihāriyasadisameva	កតយមកបាដិហារិយសទិសមេវ
kataṃ	កតំ
katena	កតេន
kathanaṃ	កថនំ
kathayanto	កថយន្តោ
kathaṃ	កថំ
kathenti	កថេន្តិ
kathento	កថេន្តោ
kathentā	កថេន្តា
kathentāpi	កថេន្តាបិ
kathesi	កថេសិ
kathessatīti	កថេស្សតីតិ
kathesīti	កថេសីតិ
kathetabbā	កថេតព្ពា
kathetu	កថេតុ
kathito	កថិតោ
kathitoti	កថិតោតិ
kathitāti	កថិតាតិ
kathā	កថា
kathāpavattinī	កថាបវត្តិនី
kathāti	កថាតិ
kathāvatthu	កថាវត្ថុ
kathāvatthunā	កថាវត្ថុនា
kathāvatthunāva	កថាវត្ថុនាវ
kathāvatthuppakaraṇaṃ	កថាវត្ថុប្បករណំ
kathāvatthuṃ	កថាវត្ថុំ
katipayāni	កតិបយានិ
katipayāva	កតិបយាវ
kato	កតោ
kattabbakiccanti	កត្តព្ពកិច្ចន្តិ
kattabbakiccaṃ	កត្តព្ពកិច្ចំ
kattaradaṇḍaṃ	កត្តរទណ្ឌំ
katvā	កត្វា
katvāna	កត្វាន
katābhinīhārena	កតាភិនីហារេន
katābhinīhārānaṃ	កតាភិនីហារានំ
kavāṭā	កវាដា
kañcanapabbatamhi	កញ្ចនបព្ពតម្ហិ
kañci	កញ្ចិ
kaṅkhā	កង្ខា
kaṇhapakkhasukkapakkhe	កណ្ហបក្ខសុក្កបក្ខេ
kaṇikārarukkho	កណិការរុក្ខោ
kaṇḍakaṃ	កណ្ឌកំ
kaṇḍambarukkhamūle	កណ្ឌម្ពរុក្ខមូលេ
kaṇṭhe	កណ្ឋេ
kaṭṭhattharikāya	កដ្ឋត្ថរិកាយ
ke	កេ
keci	កេចិ
kena	កេន
kenaṭṭhena	កេនដ្ឋេន
kesaggamattampi	កេសគ្គមត្តម្បិ
kevalañca	កេវលញ្ច
kevalaṃ	កេវលំ
khajjopanako	ខជ្ជោបនកោ
khamanti	ខមន្តិ
khanati	ខនតិ
khandhabhāramahicchabhāvo	ខន្ធភារមហិច្ឆភាវោ
khandhakā	ខន្ធកា
khandhantaraṃ	ខន្ធន្តរំ
khandhapadeso	ខន្ធបទេសោ
khandhapaññatti	ខន្ធបញ្ញត្តិ
khandhato	ខន្ធតោ
khandhavibhaṅgo	ខន្ធវិភង្គោ
khandhayamakaṃ	ខន្ធយមកំ
khandhā	ខន្ធា
khantipāramitā	ខន្តិបារមិតា
khantipāramiṃ	ខន្តិបារមិំ
khantipāramīti	ខន្តិបារមីតិ
kharadāṭhiko	ខរទាឋិកោ
khattiye	ខត្តិយេ
khattiyo	ខត្តិយោ
khayamajjhagāti	ខយមជ្ឈគាតិ
khayaṃ	ខយំ
khaye	ខយេ
khaṇe	ខណេ
khaṇo	ខណោ
khaṇḍo	ខណ្ឌោ
khemaṃ	ខេមំ
khemaṅkaro	ខេមង្ករោ
khemo	ខេមោ
khemā	ខេមា
khepetvā	ខេបេត្វា
kheḷapiṇḍaṃ	ខេឡបិណ្ឌំ
kheḷapiṇḍaṃva	ខេឡបិណ្ឌំវ
khippaṃ	ខិប្បំ
khittaṃ	ខិត្តំ
kho	ខោ
khuddakanikāyo	ខុទ្ទកនិកាយោ
khuddakanikāyoti	ខុទ្ទកនិកាយោតិ
khuddakapāṭha	ខុទ្ទកបាឋ
khuddakavagguliyoniyaṃ	ខុទ្ទកវគ្គុលិយោនិយំ
khuddakavatthuvibhaṅgo	ខុទ្ទកវត្ថុវិភង្គោ
khuddako	ខុទ្ទកោ
khuddakā	ខុទ្ទកា
khuppipāsā	ខុប្បិបាសា
khādanti	ខាទន្តិ
khādi	ខាទិ
khāditvā	ខាទិត្វា
khārikājaṃ	ខារិកាជំ
khīrassa	ខីរស្ស
khīraṃ	ខីរំ
khīre	ខីរេ
khīṇāsavo	ខីណាសវោ
khīṇāsavā	ខីណាសវា
kilantarūpā	កិលន្តរូបា
kilesabyādhīhi	កិលេសព្យាធីហិ
kilesamaladhove	កិលេសមលធោវេ
kilesapariruddho	កិលេសបរិរុទ្ធោ
kilesappahāne	កិលេសប្បហានេ
kilese	កិលេសេ
kilesā	កិលេសា
kilesānaṃ	កិលេសានំ
kilissanabhāvo	កិលិស្សនភាវោ
kilissanti	កិលិស្សន្តិ
kilissati	កិលិស្សតិ
kiliṭṭho	កិលិដ្ឋោ
kira	កិរ
kiriyato	កិរិយតោ
kismiñci	កិស្មិញ្ចិ
kissa	កិស្ស
kittakehi	កិត្តកេហិ
kittako	កិត្តកោ
kittakā	កិត្តកា
kiṃ	កិំ
kiṅkiṇikajālaṃ	កិង្កិណិកជាលំ
ko	កោ
koci	កោចិ
kolambe	កោលម្ពេ
kopānunayavajjitā	កោបានុនយវជ្ជិតា
kosiyaputto	កោសិយបុត្តោ
koṇe	កោណេ
koṇāgamano	កោណាគមនោ
koṇḍañño	កោណ្ឌញ្ញោ
koṭi	កោដិ
koṭisahassaṃ	កោដិសហស្សំ
koṭisatabhikkhū	កោដិសតភិក្ខូ
koṭisatakhīṇāsavā	កោដិសតខីណាសវា
koṭisatamabodhayi	កោដិសតមពោធយិ
koṭisatasahassabhikkhuparivārassa	កោដិសតសហស្សភិក្ខុបរិវារស្ស
koṭisatasahassabhikkhū	កោដិសតសហស្សភិក្ខូ
koṭisatasahassadhanapariccāgena	កោដិសតសហស្សធនបរិច្ចាគេន
koṭisatasahassanti	កោដិសតសហស្សន្តិ
koṭisatasahassasaṅkhassa	កោដិសតសហស្សសង្ខស្ស
koṭisatasahassasaṅkhyānaṃ	កោដិសតសហស្សសង្ខ្យានំ
koṭisatasahassaṃ	កោដិសតសហស្សំ
koṭisataṃ	កោដិសតំ
koṭiyaṃ	កោដិយំ
koṭṭente	កោដ្ដេន្តេ
koṭṭhāsaṃ	កោដ្ឋាសំ
koṭṭhāso	កោដ្ឋាសោ
koṭṭiyantopi	កោដ្ដិយន្តោបិ
kudālapaṇḍitakāle	កុទាលបណ្ឌិតកាលេ
kudālapiṭakaṃādāyātiādīsu	កុទាលបិដកំអាទាយាតិអាទីសុ
kulaparivaṭṭā	កុលបរិវដ្ដា
kulaputtānaṃ	កុលបុត្តានំ
kulaṃ	កុលំ
kumbhakārassa	កុម្ភការស្ស
kumbho	កុម្ភោ
kumbhīnañca	កុម្ភីនញ្ច
kumāra	កុមារ
kundakumudasinduvārasumanamallikādikusumasañchannā	កុន្ទកុមុទសិន្ទុវារសុមនមល្លិកាទិកុសុមសញ្ឆន្នា
kuppāmi	កុប្បាមិ
kusalacchedanābhayā	កុសលច្ឆេទនាភយា
kusalavipākato	កុសលវិបាកតោ
kusalaṃ	កុសលំ
kusalā	កុសលា
kusumānaṃ	កុសុមានំ
kutopabhavā	កុតោបភវា
kuṅkumacuṇṇakaṇikārapupphasamparikiṇṇā	កុង្កុមចុណ្ណកណិការបុប្ផសម្បរិកិណ្ណា
kuṇapaṃ	កុណបំ
kuṇḍikaṃ	កុណ្ឌិកំ
kuṭileṇacaṅkamādipaṭimaṇḍitaṃ	កុដិលេណចង្កមាទិបដិមណ្ឌិតំ
kuṭiṃ	កុដិំ
kāci	កាចិ
kāhasi	កាហសិ
kājakoṭiyā	កាជកោដិយា
kālakañjikā	កាលកញ្ជិកា
kālamakaṃsu	កាលមកំសុ
kālaṃ	កាលំ
kālaṅkatabhāvaṃ	កាលង្កតភាវំ
kāle	កាលេ
kālo	កាលោ
kāmāvacarakusalato	កាមាវចរកុសលតោ
kāraṇā	ការណា
kāraṇāni	ការណានិ
kāreti	ការេតិ
kāretvā	ការេត្វា
kārito	ការិតោ
kārāpetvā	ការាបេត្វា
kāsi	កាសិ
kāsipuraṃ	កាសិបុរំ
kātabbaṃ	កាតព្ពំ
kātunti	កាតុន្តិ
kātuṃ	កាតុំ
kāya	កាយ
kāyasakkhiṃ	កាយសក្ខិំ
kāyassa	កាយស្ស
kāyavācānañca	កាយវាចានញ្ច
kāyavācānaṃ	កាយវាចានំ
kāyaṃ	កាយំ
kāye	កាយេ
kāyo	កាយោ
kāyā	កាយា
kāḷena	កាឡេន
labhassu	លភស្សុ
labhati	លភតិ
labhatīti	លភតីតិ
labhi	លភិ
labhissāmi	លភិស្សាមិ
labhāmīti	លភាមីតិ
laddhabyākaraṇo	លទ្ធព្យាករណោ
laddhaticīvarasāṭakā	លទ្ធតិចីវរសាដកា
laddhokāsena	លទ្ធោកាសេន
laddhā	លទ្ធា
laganaṃ	លគនំ
laggitaṃ	លគ្គិតំ
lahukaṃ	លហុកំ
lahuko	លហុកោ
lahuparivattaṃ	លហុបរិវត្តំ
lahuṃ	លហុំ
lajjatīti	លជ្ជតីតិ
lakkhaṇe	លក្ខណេ
lakkhaṇīyattā	លក្ខណីយត្តា
latāpupphāni	លតាបុប្ផានិ
leḍḍu	លេឌ្ឌុ
likhitaṃ	លិខិតំ
liṅgasampatti	លិង្គសម្បត្តិ
liṅgato	លិង្គតោ
liṅgatoti	លិង្គតោតិ
liṅgena	លិង្គេន
lohitacandanena	លោហិតចន្ទនេន
lohitadhāraṃ	លោហិតធារំ
lohitarasmiyo	លោហិតរស្មិយោ
lohitaṃ	លោហិតំ
lokadhātuyo	លោកធាតុយោ
lokadhātuṃ	លោកធាតុំ
lokadhātū	លោកធាតូ
lokantaresu	លោកន្តរេសុ
lokanāthassa	លោកនាថស្ស
lokanāyakaṃ	លោកនាយកំ
lokanāyake	លោកនាយកេ
lokanāyako	លោកនាយកោ
lokasmintiādīsu	លោកស្មិន្តិអាទីសុ
lokassa	លោកស្ស
lokato	លោកតោ
lokatthacariyāyo	លោកត្ថចរិយាយោ
lokaviduṃ	លោកវិទុំ
lokavidū	លោកវិទូ
lokaṃ	លោកំ
loke	លោកេ
lokiyalokuttaro	លោកិយលោកុត្តរោ
loko	លោកោ
lokuttarakusalato	លោកុត្តរកុសលតោ
lokuttarā	លោកុត្តរា
lokā	លោកា
lomakūpamattampi	លោមកូបមត្តម្បិ
ma	ម
madhupiṇḍikasuttantādīni	មធុបិណ្ឌិកសុត្តន្តាទីនិ
madhuradhammakathaṃ	មធុរធម្មកថំ
madhurasaddo	មធុរសទ្ទោ
madhurasalilāsayaṃ	មធុរសលិលាសយំ
madhuro	មធុរោ
magadharājena	មគធរាជេន
maggapaccayo	មគ្គបច្ចយោ
maggasaccaṃ	មគ្គសច្ចំ
maggaṃ	មគ្គំ
maggaṅgavibhaṅgo	មគ្គង្គវិភង្គោ
maggo	មគ្គោ
mahagghabhāvo	មហគ្ឃភាវោ
mahallakassa	មហល្លកស្ស
mahantaṃ	មហន្តំ
mahante	មហន្តេ
mahantena	មហន្តេន
mahanto	មហន្តោ
mahesino	មហេសិនោ
mahesīhi	មហេសីហិ
mahiddhikabhāvaṃ	មហិទ្ធិកភាវំ
mahiddhiko	មហិទ្ធិកោ
mahiddhikā	មហិទ្ធិកា
mahindenetamuttamaṃ	មហិន្ទេនេតមុត្តមំ
mahindo	មហិន្ទោ
mahiyā	មហិយា
mahodadhiṃ	មហោទធិំ
mahosadhapaṇḍitakāleti	មហោសធបណ្ឌិតកាលេតិ
mahābhinikkhamanaṃ	មហាភិនិក្ខមនំ
mahābhittiyaṃ	មហាភិត្តិយំ
mahābhogo	មហាភោគោ
mahābodhimaṇḍe	មហាពោធិមណ្ឌេ
mahābodhinidāno	មហាពោធិនិទានោ
mahābodhipallaṅke	មហាពោធិបល្លង្កេ
mahābodhipallaṅkā	មហាពោធិបល្លង្កា
mahābodhiṃ	មហាពោធិំ
mahābrahmāpi	មហាព្រហ្មាបិ
mahācaṅkame	មហាចង្កមេ
mahācorasamo	មហាចោរសមោ
mahādhātukathā	មហាធាតុកថា
mahādukkhaṃ	មហាទុក្ខំ
mahādānañca	មហាទានញ្ច
mahādānaṃ	មហាទានំ
mahāgatigamiyatissadattatthero	មហាគតិគមិយតិស្សទត្តត្ថេរោ
mahāgovindakāle	មហាគោវិន្ទកាលេ
mahāgovindapaṇḍitakāle	មហាគោវិន្ទបណ្ឌិតកាលេ
mahājambuphalaṃ	មហាជម្ពុផលំ
mahājanakajātake	មហាជនកជាតកេ
mahājanassa	មហាជនស្ស
mahājanaṃ	មហាជនំ
mahājano	មហាជនោ
mahākaccānattheraṃ	មហាកច្ចានត្ថេរំ
mahākaccānena	មហាកច្ចានេន
mahākaccāno	មហាកច្ចានោ
mahākassapappamukhena	មហាកស្សបប្បមុខេន
mahākassapattherena	មហាកស្សបត្ថេរេន
mahākassapādīhi	មហាកស្សបាទីហិ
mahāmoggallānattherassa	មហាមោគ្គល្លានត្ថេរស្ស
mahāmukhaṃ	មហាមុខំ
mahāmuni	មហាមុនិ
mahānadiṃ	មហានទិំ
mahānubhāvo	មហានុភាវោ
mahānāgehi	មហានាគេហិ
mahānīparukkho	មហានីបរុក្ខោ
mahāpadhānaṃ	មហាបធានំ
mahāpakaraṇaṃ	មហាបករណំ
mahāpakaraṇe	មហាបករណេ
mahāpakaraṇeyeva	មហាបករណេយេវ
mahāpakaraṇiyā	មហាបករណិយា
mahāpathaviyā	មហាបថវិយា
mahāpathaviṃ	មហាបថវិំ
mahāpathavī	មហាបថវី
mahāpathavīkampanāni	មហាបថវីកម្បនានិ
mahāpathaṃ	មហាបថំ
mahāpañño	មហាបញ្ញោ
mahāpaññā	មហាបញ្ញា
mahāpurisassa	មហាបុរិសស្ស
mahāpurisaṃ	មហាបុរិសំ
mahāpuriso	មហាបុរិសោ
mahāpuññāni	មហាបុញ្ញានិ
mahāpīṭhaṃ	មហាបីឋំ
mahārajjaṃ	មហារជ្ជំ
mahārajjāni	មហារជ្ជានិ
mahāraṭṭhiyo	មហារដ្ឋិយោ
mahāsampattiyā	មហាសម្បត្តិយា
mahāsamuddassa	មហាសមុទ្ទស្ស
mahāsamuddaṃ	មហាសមុទ្ទំ
mahāsamudde	មហាសមុទ្ទេ
mahāsamuddeyeva	មហាសមុទ្ទេយេវ
mahāsamuddo	មហាសមុទ្ទោ
mahāsamuddova	មហាសមុទ្ទោវ
mahāsamārambhena	មហាសមារម្ភេន
mahāsattassa	មហាសត្តស្ស
mahāsattañhi	មហាសត្តញ្ហិ
mahāsattaṃ	មហាសត្តំ
mahāsatto	មហាសត្តោ
mahāsirīsarukkho	មហាសិរីសរុក្ខោ
mahāsoṇarukkho	មហាសោណរុក្ខោ
mahāsudassanarājakāle	មហាសុទស្សនរាជកាលេ
mahāsākhāhi	មហាសាខាហិ
mahāudakakkhandhotveva	មហាឧទកក្ខន្ធោត្វេវ
mahāva	មហាវ
mahāvanasaṇḍavāsīnaṃ	មហាវនសណ្ឌវាសីនំ
mahāvanasaṇḍe	មហាវនសណ្ឌេ
mahāveḷurukkho	មហាវេឡុរុក្ខោ
mahāvilokanāni	មហាវិលោកនានិ
mahāvīra	មហាវីរ
mahāvīro	មហាវីរោ
mahāyasaṃ	មហាយសំ
mahāyaso	មហាយសោ
mahītalaṃ	មហីតលំ
majjhe	មជ្ឈេ
majjhimabuddhavacanaṃ	មជ្ឈិមពុទ្ធវចនំ
majjhimanikāyo	មជ្ឈិមនិកាយោ
majjhimayāme	មជ្ឈិមយាមេ
majjhimo	មជ្ឈិមោ
mama	មម
mamaṃ	មមំ
mamokāsaṃ	មមោកាសំ
mamāti	មមាតិ
manasā	មនសា
manasādesanā	មនសាទេសនា
mandabuddhīhi	មន្ទពុទ្ធីហិ
mandacchiddo	មន្ទច្ឆិទ្ទោ
mandavāteritassa	មន្ទវាតេរិតស្ស
mandāravapupphacchattaṃ	មន្ទារវបុប្ផច្ឆត្តំ
mandāravaṃ	មន្ទារវំ
mano	មនោ
manoramaṃ	មនោរមំ
manoratho	មនោរថោ
manosilātale	មនោសិលាតលេ
mantadharo	មន្តធរោ
mantetvā	មន្តេត្វា
manujindotiādīsu	មនុជិន្ទោតិអាទីសុ
manussabhūtena	មនុស្សភូតេន
manussagaṇanāya	មនុស្សគណនាយ
manussaloke	មនុស្សលោកេ
manusse	មនុស្សេ
manussesu	មនុស្សេសុ
manussā	មនុស្សា
manussānaṃ	មនុស្សានំ
manussāpi	មនុស្សាបិ
manāpā	មនាបា
maraṇamattaṃ	មរណមត្តំ
maraṇaṃ	មរណំ
marū	មរូ
matoti	មតោតិ
matthakaṃ	មត្ថកំ
matthake	មត្ថកេ
mayaṃ	មយំ
mayha	មយ្ហ
mayhanti	មយ្ហន្តិ
mayhaṃ	មយ្ហំ
mayā	មយា
mayāpi	មយាបិ
maññe	មញ្ញេ
maṃ	មំ
maṅgalapokkharaṇītīre	មង្គលបោក្ខរណីតីរេ
maṅgalasuttaratanasuttanālakasuttatuvaṭṭakasuttāni	មង្គលសុត្តរតនសុត្តនាលកសុត្តតុវដ្ដកសុត្តានិ
maṅgalo	មង្គលោ
maṇimayā	មណិមយា
maṇiratanaṃ	មណិរតនំ
maṇitthambhesu	មណិត្ថម្ភេសុ
maṇḍapassa	មណ្ឌបស្ស
maṇḍapaṃ	មណ្ឌបំ
maṇḍape	មណ្ឌបេ
maṇḍapo	មណ្ឌបោ
me	មេ
medinī	មេទិនី
mekhalaṃ	មេខលំ
mettāpāramitā	មេត្តាបារមិតា
mettāpāramiṃ	មេត្តាបារមិំ
mettāsahagatena	មេត្តាសហគតេន
mettāya	មេត្តាយ
mettāyantassa	មេត្តាយន្តស្ស
micchādiṭṭhitaṃ	មិច្ឆាទិដ្ឋិតំ
micchāvitakkamakkhikā	មិច្ឆាវិតក្កមក្ខិកា
migadāye	មិគទាយេ
migarājā	មិគរាជា
milāyanti	មិលាយន្តិ
mitto	មិត្តោ
mocayiṃ	មោចយិំ
moggaliputtatissattherenetaṃ	មោគ្គលិបុត្តតិស្សត្ថេរេនេតំ
moggaliputtatissatthero	មោគ្គលិបុត្តតិស្សត្ថេរោ
moggaliputto	មោគ្គលិបុត្តោ
moggallānenāti	មោគ្គល្លានេនាតិ
moggallāno	មោគ្គល្លានោ
moghapurisā	មោឃបុរិសា
moho	មោហោ
morapiñchakalāpo	មោរបិញ្ឆកលាបោ
muccanti	មុច្ចន្តិ
mucchitā	មុច្ឆិតា
mudukā	មុទុកា
mudutalaṃ	មុទុតលំ
muggavaṇṇasilaṃ	មុគ្គវណ្ណសិលំ
muggavaṇṇasilāpaṭṭe	មុគ្គវណ្ណសិលាបដ្ដេ
muhuttaṃ	មុហុត្តំ
mukhaṃ	មុខំ
mukhādānaṃ	មុខាទានំ
muttimeva	មុត្តិមេវ
muttāhāraṃ	មុត្តាហារំ
muttājālasadisāya	មុត្តាជាលសទិសាយ
muñcitvā	មុញ្ចិត្វា
muñcitvāhaṃ	មុញ្ចិត្វាហំ
muñcāmimaṃ	មុញ្ចាមិមំ
muñjatiṇaṃ	មុញ្ជតិណំ
muḷālakalāpaṃ	មុឡាលកលាបំ
mā	មា
mālā	មាលា
mālāgandhūpahārādīhi	មាលាគន្ធូបហារាទីហិ
mānamadapurisamade	មានមទបុរិសមទេ
mānasaṃ	មានសំ
mānusakaṃ	មានុសកំ
mānusakā	មានុសកា
mānusaṃ	មានុសំ
mānusehi	មានុសេហិ
mānusā	មានុសា
māpehīti	មាបេហីតិ
māpesi	មាបេសិ
māpesinti	មាបេសិន្តិ
māpesiṃ	មាបេសិំ
māpetvā	មាបេត្វា
māpitā	មាបិតា
mārabalaṃ	មារពលំ
mārasenaṃ	មារសេនំ
māreti	មារេតិ
māse	មាសេ
māsehi	មាសេហិ
mātaraṃ	មាតរំ
mātikaṃ	មាតិកំ
mātikā	មាតិកា
mātikāṭhapanaṃ	មាតិកាឋបនំ
mātito	មាតិតោ
mātu	មាតុ
mātukucchiyaṃ	មាតុកុច្ឆិយំ
mātukucchiṃ	មាតុកុច្ឆិំ
mātā	មាតា
mātāpi	មាតាបិ
mātāpitaro	មាតាបិតរោ
māyā	មាយា
māṇavo	មាណវោ
mūgapakkhikā	មូគបក្ខិកា
mūlapariyāyasuttādīni	មូលបរិយាយសុត្តាទីនិ
mūlato	មូលតោ
mūlayamakaṃ	មូលយមកំ
mūlādīhi	មូលាទីហិ
na	ន
nabhe	នភេ
nadanaṃ	នទនំ
naditvā	នទិត្វា
nadiyo	នទិយោ
nadiyā	នទិយា
nadiṃ	នទិំ
nadīnivattane	នទីនិវត្តនេ
nagaradvāresu	នគរទ្វារេសុ
nagaraṃ	នគរំ
nagare	នគរេ
nahetū	នហេតូ
nakhāpi	នខាបិ
nakkhattā	នក្ខត្តា
nakulā	នកុលា
nalāṭaṃ	នលាដំ
namassanti	នមស្សន្តិ
namassitvā	នមស្សិត្វា
nandamātā	នន្ទមាតា
nanti	នន្តិ
nanu	ននុ
napi	នបិ
napihaṃ	នបិហំ
nappahotiyeva	នប្បហោតិយេវ
nappakanti	នប្បកន្តិ
nappaṭicchādeti	នប្បដិច្ឆាទេតិ
naramarū	នរមរូ
naranāriyo	នរនារិយោ
narā	នរា
narāsabho	នរាសភោ
natthi	នត្ថិ
natthipaccayo	នត្ថិបច្ចយោ
natthīti	នត្ថីតិ
nava	នវ
navacchiddaṃ	នវច្ឆិទ្ទំ
navadosamupāgata	នវទោសមុបាគត
navadosamupāgataṃ	នវទោសមុបាគតំ
navamaṃ	នវមំ
navamo	នវមោ
navappabhedaṃ	នវប្បភេទំ
navaṅgāni	នវង្គានិ
navaṅgānīti	នវង្គានីតិ
navuti	នវុតិ
navutihatthubbedhaṃ	នវុតិហត្ថុព្ពេធំ
navutikoṭimabodhayi	នវុតិកោដិមពោធយិ
navutikoṭisahassāni	នវុតិកោដិសហស្សានិ
navutikoṭisaṅkhyāya	នវុតិកោដិសង្ខ្យាយ
navutikoṭiyo	នវុតិកោដិយោ
navutivassasahassāni	នវុតិវស្សសហស្សានិ
navutivassasahassānīti	នវុតិវស្សសហស្សានីតិ
navutiyeva	នវុតិយេវ
nayadānaṃ	នយទានំ
nayamukhaṃ	នយមុខំ
nayasahassena	នយសហស្សេន
nayasatasahassena	នយសតសហស្សេន
nayasatena	នយសតេន
nayasāgaro	នយសាគរោ
nayato	នយតោ
nayaṃ	នយំ
nayehi	នយេហិ
nayena	នយេន
nayo	នយោ
nayā	នយា
nayānaṃ	នយានំ
naṃ	នំ
naṅguṭṭhe	នង្គុដ្ឋេ
naṭṭhepi	នដ្ឋេបិ
ne	នេ
nekakoṭisataṃ	នេកកោដិសតំ
nekkhamagavesako	នេក្ខមគវេសកោ
nekkhammapāramitā	នេក្ខម្មបារមិតា
nekkhammapāramitāya	នេក្ខម្មបារមិតាយ
nekkhammapāramiṃ	នេក្ខម្មបារមិំ
nekkhammapāramīti	នេក្ខម្មបារមីតិ
nekkhammaṃ	នេក្ខម្មំ
nerañjaramupehiti	នេរញ្ជរមុបេហិតិ
nerañjarāya	នេរញ្ជរាយ
nesaṃ	នេសំ
neva	នេវ
ni	និ
nibaddhajagganabhāvo	និពទ្ធជគ្គនភាវោ
nibbanti	និព្ពន្តិ
nibbattesi	និព្ពត្តេសិ
nibbattetvā	និព្ពត្តេត្វា
nibbatti	និព្ពត្តិ
nibbattiṃsu	និព្ពត្តិំសុ
nibbattā	និព្ពត្តា
nibbhayabhāvo	និព្ភយភាវោ
nibbinnahadayo	និព្ពិន្នហទយោ
nibbutapadaṃ	និព្ពុតបទំ
nibbutapiṇḍabhuñjanabhāvo	និព្ពុតបិណ្ឌភុញ្ជនភាវោ
nibbutiṃ	និព្ពុតិំ
nibbuto	និព្ពុតោ
nibbutā	និព្ពុតា
nibbānaṃ	និព្ពានំ
nibbāyi	និព្ពាយិ
niccakālaṃ	និច្ចកាលំ
niccalabhāvakaraṇatthaṃ	និច្ចលភាវករណត្ថំ
niccalāva	និច្ចលាវ
niccameva	និច្ចមេវ
niccaṃ	និច្ចំ
nicchandarāgabhāvo	និច្ឆន្ទរាគភាវោ
nicchārento	និច្ឆារេន្តោ
nicchāretvā	និច្ឆារេត្វា
nidahitvā	និទហិត្វា
niddhantasuvaṇṇapiṇḍi	និទ្ធន្តសុវណ្ណបិណ្ឌិ
niddiṭṭhaṃ	និទ្ទិដ្ឋំ
niddosaṃ	និទ្ទោសំ
niddāvasena	និទ្ទាវសេន
niddāyantena	និទ្ទាយន្តេន
nidānakathā	និទានកថា
nidānakiccaṃ	និទានកិច្ចំ
nidānakosallatthaṃ	និទានកោសល្លត្ថំ
nidānassa	និទានស្ស
nidānaṃ	និទានំ
nidānāni	និទានានិ
nigaccheyya	និគច្ឆេយ្យ
niggacchati	និគ្គច្ឆតិ
niggahaṃ	និគ្គហំ
niggahaṃpe	និគ្គហំបេ
niggahito	និគ្គហិតោ
niggāthakaṃ	និគ្គាថកំ
nigrodharukkho	និគ្រោធរុក្ខោ
nijjhānaṃ	និជ្ឈានំ
nikhilena	និខិលេន
nikkhamantassa	និក្ខមន្តស្ស
nikkhamanti	និក្ខមន្តិ
nikkhamantūti	និក្ខមន្តូតិ
nikkhamathāti	និក្ខមថាតិ
nikkhamitvā	និក្ខមិត្វា
nikkhamiṃsu	និក្ខមិំសុ
nikkhantasayanassa	និក្ខន្តសយនស្ស
nikkhantaudakadhārā	និក្ខន្តឧទកធារា
nikkhantaṃ	និក្ខន្តំ
nikkhanto	និក្ខន្តោ
nikkhantosmi	និក្ខន្តោស្មិ
nikkhantā	និក្ខន្តា
nikkhepakaṇḍeyeva	និក្ខេបកណ្ឌេយេវ
nikkheparāsi	និក្ខេបរាសិ
nikkhepaṃ	និក្ខេបំ
nikkhepo	និក្ខេបោ
nikkhepoti	និក្ខេបោតិ
nikkhipitvā	និក្ខិបិត្វា
nikkhittaṃ	និក្ខិត្តំ
nikāyabhāve	និកាយភាវេ
nikāyato	និកាយតោ
nikāye	និកាយេ
nikāyo	និកាយោ
nikāyoti	និកាយោតិ
nikāyā	និកាយា
nikāyāti	និកាយាតិ
nimantessāmīti	និមន្តេស្សាមីតិ
nimantetvā	និមន្តេត្វា
nimantitā	និមន្តិតា
nimantiyamāno	និមន្តិយមានោ
nimimahārājakāle	និមិមហារាជកាលេ
nimittaggāhamattakeneva	និមិត្តគ្គាហមត្តកេនេវ
nimittaṃ	និមិត្តំ
nimitte	និមិត្តេ
nimminitvā	និម្មិនិត្វា
nimmitabuddhassa	និម្មិតពុទ្ធស្ស
nimmitabuddhaṃ	និម្មិតពុទ្ធំ
nimmānaratī	និម្មានរតី
ninnetā	និន្នេតា
nipajjahaṃ	និបជ្ជហំ
nipannassa	និបន្នស្ស
nipannena	និបន្នេន
nipanno	និបន្នោ
nippadesato	និប្បទេសតោ
nippadesatova	និប្បទេសតោវ
nippadesena	និប្បទេសេន
nipphannaṃ	និប្ផន្នំ
nipuṇaṃ	និបុណំ
nipuṇāmalabuddhinā	និបុណាមលពុទ្ធិនា
nirantaraṃ	និរន្តរំ
niravasesato	និរវសេសតោ
nirayā	និរយា
nirodhasaccaṃ	និរោធសច្ចំ
nirodhasamāpattisamāpannaṃ	និរោធសមាបត្តិសមាបន្នំ
nirodhā	និរោធា
nirupabhogabhāvo	និរុបភោគភាវោ
nirākulā	និរាកុលា
nisabho	និសភោ
nisajjaṭṭhānacaṅkame	និសជ្ជដ្ឋានចង្កមេ
nisinnasattāhaṃ	និសិន្នសត្តាហំ
nisinnena	និសិន្នេន
nisinno	និសិន្នោ
nisinnā	និសិន្នា
nissaddā	និស្សទ្ទា
nissandena	និស្សន្ទេន
nissaraṇatthā	និស្សរណត្ថា
nissayapaccayo	និស្សយបច្ចយោ
nissaṅgatāya	និស្សង្គតាយ
nissesaṃ	និស្សេសំ
nissāya	និស្សាយ
nisāmetha	និសាមេថ
nisīdanamaṇḍapaṃ	និសីទនមណ្ឌបំ
nisīdanatthāya	និសីទនត្ថាយ
nisīdanaṭṭhānatthāya	និសីទនដ្ឋានត្ថាយ
nisīdanaṭṭhānaṃ	និសីទនដ្ឋានំ
nisīdati	និសីទតិ
nisīdi	និសីទិ
nisīditvā	និសីទិត្វា
nisīdiṃsu	និសីទិំសុ
nisīdāpetvā	និសីទាបេត្វា
nivatta	និវត្ត
nivatthapārutaṃ	និវត្ថបារុតំ
nivattitvā	និវត្តិត្វា
nivesesi	និវេសេសិ
nivāsanapārupanatthāya	និវាសនបារុបនត្ថាយ
nivāsanānurūpaṃ	និវាសនានុរូបំ
nivāsaphāsukaṃ	និវាសផាសុកំ
nivāsato	និវាសតោ
nivāsesi	និវាសេសិ
nivāsesiṃ	និវាសេសិំ
nivāsetvā	និវាសេត្វា
niyatā	និយតា
niyyātetvā	និយ្យាតេត្វា
niṭṭhitā	និដ្ឋិតា
niṭṭhubhanādīhi	និដ្ឋុភនាទីហិ
niṭṭhāpetvā	និដ្ឋាបេត្វា
no	នោ
nosuttanāmikā	នោសុត្តនាមិកា
nti	ន្តិ
ntipi	ន្តិបិ
nu	នុ
nuddhaṃsati	នុទ្ធំសតិ
nupalabbhati	នុបលព្ភតិ
nupapajjare	នុបបជ្ជរេ
nuppajjanti	នុប្បជ្ជន្តិ
nuppajji	នុប្បជ្ជិ
nāddasaṃ	នាទ្ទសំ
nāgabhavanā	នាគភវនា
nāgalatādantakaṭṭhaṃ	នាគលតាទន្តកដ្ឋំ
nāgapunnāgaketakaṃ	នាគបុន្នាគកេតកំ
nāgarukkho	នាគរុក្ខោ
nāgarukkhova	នាគរុក្ខោវ
nāgarājena	នាគរាជេន
nāgarājā	នាគរាជា
nāgasamālā	នាគសមាលា
nāgā	នាគា
nāhaṃ	នាហំ
nāhesunti	នាហេសុន្តិ
nāhesuṃ	នាហេសុំ
nāhosi	នាហោសិ
nālaṃ	នាលំ
nāma	នាម
nāmahaṃ	នាមហំ
nāmapadeso	នាមបទេសោ
nāmapi	នាមបិ
nāmarūpaparicchedakathā	នាមរូបបរិច្ឆេទកថា
nāmarūpaparicchedo	នាមរូបបរិច្ឆេទោ
nāmato	នាមតោ
nāmaṃ	នាមំ
nāmesa	នាមេស
nāmetanti	នាមេតន្តិ
nāmupaṭṭhāko	នាមុបដ្ឋាកោ
nāmāti	នាមាតិ
nānappakārakosallatthaṃ	នានប្បការកោសល្លត្ថំ
nānappakārato	នានប្បការតោ
nānattaṃ	នានត្តំ
nānattābhāvā	នានត្តាភាវា
nānubhonti	នានុភោន្តិ
nānājanasamākulaṃ	នានាជនសមាកុលំ
nānākuṇapapūritaṃ	នានាកុណបបូរិតំ
nānākuṇapasañcayaṃ	នានាកុណបសញ្ចយំ
nānāsamāpattīhi	នានាសមាបត្តីហិ
nānāvirāgavaṇṇavisesasampanno	នានាវិរាគវណ្ណវិសេសសម្បន្នោ
nāradakūṭamhi	នារទកូដម្ហិ
nārado	នារទោ
nārī	នារី
nāsakkhi	នាសក្ខិ
nāsakkhiṃsu	នាសក្ខិំសុ
nātho	នាថោ
nāvaṃ	នាវំ
nāvāya	នាវាយ
nāyaṃ	នាយំ
nāṭakānaṃ	នាដកានំ
nīharaṇābhāvo	នីហរណាភាវោ
nīhārena	នីហារេន
nīlapeyyālaṃ	នីលបេយ្យាលំ
nīlapītalohitodātamañjiṭṭhapabhassaravasena	នីលបីតលោហិតោទាតមញ្ជិដ្ឋបភស្សរវសេន
nīlarasmiyo	នីលរស្មិយោ
nīlaṭṭhānehi	នីលដ្ឋានេហិ
nīpaṃ	នីបំ
nūna	នូន
obhāsanasamatthaṃ	ឱភាសនសមត្ថំ
obhāsayamantalikkhanti	ឱភាសយមន្តលិក្ខន្តិ
odahitvā	ឱទហិត្វា
odātarasmiyo	ឱទាតរស្មិយោ
oghataraṇādīni	ឱឃតរណាទីនិ
ogāḷhassa	ឱគាឡ្ហស្ស
okiranti	ឱកិរន្តិ
okkamati	ឱក្កមតិ
okkamītiādīnaṃ	ឱក្កមីតិអាទីនំ
okkanti	ឱក្កន្តិ
okāsaṃ	ឱកាសំ
olaggetvā	ឱលគ្គេត្វា
olambantā	ឱលម្ពន្តា
olambantūti	ឱលម្ពន្តូតិ
olambatūti	ឱលម្ពតូតិ
olambi	ឱលម្ពិ
olambitvā	ឱលម្ពិត្វា
olambiṃsu	ឱលម្ពិំសុ
olokaneneva	ឱលោកនេនេវ
olokento	ឱលោកេន្តោ
olokesi	ឱលោកេសិ
oloketi	ឱលោកេតិ
oloketvā	ឱលោកេត្វា
omuñcanto	ឱមុញ្ចន្តោ
orabhāge	ឱរភាគេ
orimatīraṃ	ឱរិមតីរំ
oruyha	ឱរុយ្ហ
osamī	ឱសមី
osaranti	ឱសរន្តិ
osarantu	ឱសរន្តុ
otāretvā	ឱតារេត្វា
ovadati	ឱវទតិ
pa	ប
pabbajantūti	បព្ពជន្តូតិ
pabbaji	បព្ពជិ
pabbajissāmīti	បព្ពជិស្សាមីតិ
pabbajitaṃ	បព្ពជិតំ
pabbajito	បព្ពជិតោ
pabbajitukāmā	បព្ពជិតុកាមា
pabbajitvā	បព្ពជិត្វា
pabbajitā	បព្ពជិតា
pabbajitānañhi	បព្ពជិតានញ្ហិ
pabbajitānaṃ	បព្ពជិតានំ
pabbajiṃsu	បព្ពជិំសុ
pabbajjasuttādīnaṃ	បព្ពជ្ជសុត្តាទីនំ
pabbajjā	បព្ពជ្ជា
pabbajjāti	បព្ពជ្ជាតិ
pabbajjāya	បព្ពជ្ជាយ
pabbate	បព្ពតេ
pabbato	បព្ពតោ
pabbaṃ	បព្ពំ
pabbhāre	បព្ភារេ
pabbājento	បព្ពាជេន្តោ
pabhedavacanato	បភេទវចនតោ
pabhedaṃ	បភេទំ
pabhā	បភា
pabhāvatī	បភាវតី
pabhāvito	បភាវិតោ
pabhāya	បភាយ
pabujjhitvā	បពុជ្ឈិត្វា
paccanīyamhi	បច្ចនីយម្ហិ
paccanīyepi	បច្ចនីយេបិ
paccanīyānulomamhi	បច្ចនីយានុលោមម្ហិ
paccanīyānulome	បច្ចនីយានុលោមេ
paccanīyānulomepi	បច្ចនីយានុលោមេបិ
paccatthikā	បច្ចត្ថិកា
paccatthikānaṃ	បច្ចត្ថិកានំ
paccavekkhantassa	បច្ចវេក្ខន្តស្ស
paccavekkhanto	បច្ចវេក្ខន្តោ
paccavekkhantānaṃ	បច្ចវេក្ខន្តានំ
paccayākārapadeso	បច្ចយាការបទេសោ
paccayākāravaṭṭaṃ	បច្ចយាការវដ្ដំ
paccayākāravibhaṅgo	បច្ចយាការវិភង្គោ
paccayākāre	បច្ចយាការេ
paccayākāro	បច្ចយាការោ
paccayānaṃ	បច្ចយានំ
paccekaṃ	បច្ចេកំ
pacchimabuddhavacanaṃ	បច្ឆិមពុទ្ធវចនំ
pacchimayāmāvasāne	បច្ឆិមយាមាវសានេ
pacchimuttarāya	បច្ឆិមុត្តរាយ
pacchā	បច្ឆា
pacchājātapaccayo	បច្ឆាជាតបច្ចយោ
pacchāpi	បច្ឆាបិ
pacurāparādhā	បចុរាបរាធា
padabhājanīyaṃ	បទភាជនីយំ
padahitvā	បទហិត្វា
padahitvāna	បទហិត្វាន
padahiṃ	បទហិំ
padakkhiṇamakaṃsu	បទក្ខិណមកំសុ
padakkhiṇaṃ	បទក្ខិណំ
padanti	បទន្តិ
padasahassāni	បទសហស្សានិ
padavalañjaṃ	បទវលញ្ជំ
padesavihārasuttantavasena	បទេសវិហារសុត្តន្តវសេន
padesavihārasuttantaṃ	បទេសវិហារសុត្តន្តំ
padesaṃ	បទេសំ
padese	បទេសេ
padesena	បទេសេន
padeso	បទេសោ
padissanti	បទិស្សន្តិ
padissare	បទិស្សរេ
padissati	បទិស្សតិ
padumagabbhaṃ	បទុមគព្ភំ
padumaṃ	បទុមំ
padumo	បទុមោ
padumuttaro	បទុមុត្តរោ
padumā	បទុមា
paggahitamano	បគ្គហិតមនោ
paggayha	បគ្គយ្ហ
paggaṇha	បគ្គណ្ហ
paggharatīti	បគ្ឃរតីតិ
paghaṭṭitā	បឃដ្ដិតា
pahotīti	បហោតីតិ
pahānaṃ	បហានំ
pahānāni	បហានានិ
pahāraṃ	បហារំ
pahāya	បហាយ
pahīnakileso	បហីនកិលេសោ
pahīnaṃ	បហីនំ
pahūtadhanadhaññavā	បហូតធនធញ្ញវា
pajahanto	បជហន្តោ
pajahi	បជហិ
pajahinti	បជហិន្តិ
pajahitvā	បជហិត្វា
pajahiṃ	បជហិំ
pajānāti	បជានាតិ
pakampatha	បកម្បថ
pakampathāti	បកម្បថាតិ
pakampati	បកម្បតិ
pakaraṇaṃ	បករណំ
pakaraṇānaṃ	បករណានំ
pakaraṇāni	បករណានិ
pakittetvā	បកិត្តេត្វា
pakkamadhusakkaracuṇṇasappīhi	បក្កមធុសក្ករចុណ្ណសប្បីហិ
pakkamati	បក្កមតិ
pakkamuṃ	បក្កមុំ
pakkhalitvā	បក្ខលិត្វា
pakkhandiṃsu	បក្ខន្ទិំសុ
pakkhipitvā	បក្ខិបិត្វា
pakāsayissāmi	បកាសយិស្សាមិ
pakāsitaṃ	បកាសិតំ
palibodhato	បលិពោធតោ
pallaṅkasmiñhi	បល្លង្កស្មិញ្ហិ
pallaṅkassa	បល្លង្កស្ស
pallaṅkavaramābhuje	បល្លង្កវរមាភុជេ
pallaṅkaṃ	បល្លង្កំ
pallaṅke	បល្លង្កេ
pallaṅkā	បល្លង្កា
paluggaṃ	បលុគ្គំ
palālasakaṭe	បលាលសកដេ
palāyati	បលាយតិ
pamoditaṃ	បមោទិតំ
pamodito	បមោទិតោ
pamokāse	បមោកាសេ
pamudito	បមុទិតោ
pamukhaṃ	បមុខំ
pamādacāraṃ	បមាទចារំ
pamādamāgamma	បមាទមាគម្ម
pamāṇaṃ	បមាណំ
pana	បន
panassa	បនស្ស
panesa	បនេស
panesā	បនេសា
panetaṃ	បនេតំ
panete	បនេតេ
panettha	បនេត្ថ
panidaṃ	បនិទំ
pannarasappabhedo	បន្នរសប្បភេទោ
panāha	បនាហ
papañcasaññāsaṅkhā	បបញ្ចសញ្ញាសង្ខា
papañco	បបញ្ចោ
paralokaṃ	បរលោកំ
paramatthabāhullato	បរមត្ថពាហុល្លតោ
paramatthadesanā	បរមត្ថទេសនា
paramatthakusalena	បរមត្ថកុសលេន
paramatthapāramī	បរមត្ថបារមី
paramattho	បរមត្ថោ
paramāya	បរមាយ
paranimmitavasavattī	បរនិម្មិតវសវត្តី
parapaṭibaddhatāya	បរបដិពទ្ធតាយ
paratīraṃ	បរតីរំ
paravāde	បរវាទេ
paravādinā	បរវាទិនា
paravādī	បរវាទី
paraṃ	បរំ
pari	បរិ
paribhaṇḍakatā	បរិភណ្ឌកតា
paribhogaphāsukaṃ	បរិភោគផាសុកំ
paribhogena	បរិភោគេន
paribhuñjantassa	បរិភុញ្ជន្តស្ស
paribhuñjitvā	បរិភុញ្ជិត្វា
paribāhirāti	បរិពាហិរាតិ
pariccajituṃ	បរិច្ចជិតុំ
pariccajiṃ	បរិច្ចជិំ
paricchedamattakameva	បរិច្ឆេទមត្តកមេវ
paricchede	បរិច្ឆេទេ
paricchedo	បរិច្ឆេទោ
paricchinne	បរិច្ឆិន្នេ
paricchinno	បរិច្ឆិន្នោ
paricchinnā	បរិច្ឆិន្នា
paricchinnāpi	បរិច្ឆិន្នាបិ
paridahitvā	បរិទហិត្វា
paridīpanā	បរិទីបនា
paridīpaye	បរិទីបយេ
paridīpayeti	បរិទីបយេតិ
paridīpitadhammakkhandhavasena	បរិទីបិតធម្មក្ខន្ធវសេន
pariggahakaraṇabhāvo	បរិគ្គហករណភាវោ
parihariyamāno	បរិហរិយមានោ
parikkhipanto	បរិក្ខិបន្តោ
parikkhāre	បរិក្ខារេ
parimoceti	បរិមោចេតិ
parimuttiyā	បរិមុត្តិយា
parimāṇaṃ	បរិមាណំ
parinibbutassa	បរិនិព្ពុតស្ស
parinibbute	បរិនិព្ពុតេ
parinibbānasamaye	បរិនិព្ពានសមយេ
parinibbānato	បរិនិព្ពានតោ
paripucchaṃ	បរិបុច្ឆំ
paripācito	បរិបាចិតោ
paripīḷito	បរិបីឡិតោ
paripūraya	បរិបូរយ
paripūrento	បរិបូរេន្តោ
paripūressantīti	បរិបូរេស្សន្តីតិ
parirakkhati	បរិរក្ខតិ
pariruddho	បរិរុទ្ធោ
parisapariyante	បរិសបរិយន្តេ
parisaṃ	បរិសំ
parisuddho	បរិសុទ្ធោ
parisā	បរិសា
parisāya	បរិសាយ
parivattento	បរិវត្តេន្តោ
parivesane	បរិវេសនេ
parivisituṃ	បរិវិសិតុំ
parivisiṃsu	បរិវិសិំសុ
parivitakko	បរិវិតក្កោ
parivārayiṃsu	បរិវារយិំសុ
parivārenti	បរិវារេន្តិ
parivārito	បរិវារិតោ
parivārā	បរិវារា
parivārāti	បរិវារាតិ
pariyattibbhājanatthato	បរិយត្តិព្ភាជនត្ថតោ
pariyattibhedo	បរិយត្តិភេទោ
pariyattibhājanatthato	បរិយត្តិភាជនត្ថតោ
pariyattibhāvato	បរិយត្តិភាវតោ
pariyattiyo	បរិយត្តិយោ
pariyesantassa	បរិយេសន្តស្ស
pariyesissāmi	បរិយេសិស្សាមិ
pariyesitvā	បរិយេសិត្វា
pariyonaddhā	បរិយោនទ្ធា
pariyuṭṭhānapaṭipakkhattā	បរិយុដ្ឋានបដិបក្ខត្តា
pariyuṭṭhānappahānaṃ	បរិយុដ្ឋានប្បហានំ
pariyāpannā	បរិយាបន្នា
pariyāpuṇanti	បរិយាបុណន្តិ
pariyāpuṇassu	បរិយាបុណស្សុ
pariyāpuṇissasīti	បរិយាបុណិស្សសីតិ
pariyāpuṇituṃ	បរិយាបុណិតុំ
pariyāpuṇitvā	បរិយាបុណិត្វា
pariyāpuṇāti	បរិយាបុណាតិ
pariyāpuṭā	បរិយាបុដា
pariññātakkhandho	បរិញ្ញាតក្ខន្ធោ
pasannacitto	បសន្នចិត្តោ
pasavatīti	បសវតីតិ
passa	បស្ស
passantasseva	បស្សន្តស្សេវ
passanti	បស្សន្តិ
passati	បស្សតិ
passatīti	បស្សតីតិ
passaṃ	បស្សំ
passesu	បស្សេសុ
passeyya	បស្សេយ្យ
passi	បស្សិ
pasādabahulānaṃ	បសាទពហុលានំ
pasādeti	បសាទេតិ
pasādetvā	បសាទេត្វា
pasāretvā	បសារេត្វា
pasāritarajatapaṭṭasumanapupphasantharasadiso	បសារិតរជតបដ្ដសុមនបុប្ផសន្ថរសទិសោ
pasīdi	បសីទិ
pasīditvā	បសីទិត្វា
patati	បតតិ
pathavikampane	បថវិកម្បនេ
pathaviṃ	បថវិំ
pathavī	បថវី
pathe	បថេ
patitāsu	បតិតាសុ
patiṭṭhaha	បតិដ្ឋហ
patiṭṭhāsi	បតិដ្ឋាសិ
patiṭṭhāya	បតិដ្ឋាយ
pattacīvaramādāya	បត្តចីវរមាទាយ
pattaggahaṇaṃ	បត្តគ្គហណំ
pattaṃ	បត្តំ
patte	បត្តេ
patthanaṃ	បត្ថនំ
pattharitvāna	បត្ថរិត្វាន
patthitaṃ	បត្ថិតំ
patto	បត្តោ
pattumicchasi	បត្តុមិច្ឆសិ
pattuṇṇacīnapaṭakoseyyakambaladukulāni	បត្តុណ្ណចីនបដកោសេយ្យកម្ពលទុកុលានិ
pattāni	បត្តានិ
patvā	បត្វា
patvāte	បត្វាតេ
patīti	បតីតិ
pavanaṃ	បវនំ
pavane	បវនេ
pavassanti	បវស្សន្តិ
pavattanasamatthaṃ	បវត្តនសមត្ថំ
pavattaphalabhojano	បវត្តផលភោជនោ
pavattaphalamādiyiṃ	បវត្តផលមាទិយិំ
pavattaya	បវត្តយ
pavattayuṃ	បវត្តយុំ
pavattento	បវត្តេន្តោ
pavattesuṃ	បវត្តេសុំ
pavattetvā	បវត្តេត្វា
pavattinoti	បវត្តិនោតិ
pavattitadesanā	បវត្តិតទេសនា
pavattittha	បវត្តិត្ថ
pavattā	បវត្តា
pavecchati	បវេច្ឆតិ
pavedayiṃ	បវេទយិំ
pavesetvā	បវេសេត្វា
paveṇipālanatthāya	បវេណិបាលនត្ថាយ
pavisanto	បវិសន្តោ
pavisissāmīti	បវិសិស្សាមីតិ
pavisitvā	បវិសិត្វា
pavivekagate	បវិវេកគតេ
pavivekakkhamaṃ	បវិវេកក្ខមំ
pavivekamanubrūhetuṃ	បវិវេកមនុព្រូហេតុំ
pavivekañhi	បវិវេកញ្ហិ
paviṭṭhakālo	បវិដ្ឋកាលោ
paviṭṭhena	បវិដ្ឋេន
paviṭṭho	បវិដ្ឋោ
pavuccati	បវុច្ចតិ
pavuccatīti	បវុច្ចតីតិ
pavāheti	បវាហេតិ
pavāhetvā	បវាហេត្វា
pavāresi	បវារេសិ
pavāyati	បវាយតិ
pavāḷamayā	បវាឡមយា
pavāḷatthambhesu	បវាឡត្ថម្ភេសុ
pavāḷavaṇṇaṃ	បវាឡវណ្ណំ
payirudāhāsi	បយិរុទាហាសិ
payirupāsamāno	បយិរុបាសមានោ
pañca	បញ្ច
pañcacattālīsa	បញ្ចចត្តាលីស
pañcadasa	បញ្ចទស
pañcadasappabhedā	បញ្ចទសប្បភេទា
pañcadasavaggasaṅgahāni	បញ្ចទសវគ្គសង្គហានិ
pañcadosavivajjitanti	បញ្ចទោសវិវជ្ជិតន្តិ
pañcadosavivajjitaṃ	បញ្ចទោសវិវជ្ជិតំ
pañcakkhandhe	បញ្ចក្ខន្ធេ
pañcakkhandhā	បញ្ចក្ខន្ធា
pañcakānaṃ	បញ្ចកានំ
pañcamattabhāṇavāro	បញ្ចមត្តភាណវារោ
pañcamaṃ	បញ្ចមំ
pañcamo	បញ្ចមោ
pañcannaṃ	បញ្ចន្នំ
pañcappabhedaṃ	បញ្ចប្បភេទំ
pañcasatasahassakahāpaṇāni	បញ្ចសតសហស្សកហាបណានិ
pañcasatikasaṅgītikāle	បញ្ចសតិកសង្គីតិកាលេ
pañcasu	បញ្ចសុ
pañcatiṃsamattabhāṇavāraṃ	បញ្ចតិំសមត្តភាណវារំ
pañcavaggiyānaṃ	បញ្ចវគ្គិយានំ
pañcavassasahassaparimāṇakālaṃ	បញ្ចវស្សសហស្សបរិមាណកាលំ
pañcavaṇṇāya	បញ្ចវណ្ណាយ
pañcavidhapātimokkhuddesapārājikādisattaāpattikkhandhamātikāvibhaṅgādippabhedā	បញ្ចវិធបាតិមោក្ខុទ្ទេសបារាជិកាទិសត្តអាបត្តិក្ខន្ធមាតិកាវិភង្គាទិប្បភេទា
pañcaṅgikasseva	បញ្ចង្គិកស្សេវ
pañcime	បញ្ចិមេ
pañcābhiññāsu	បញ្ចាភិញ្ញាសុ
pañcāti	បញ្ចាតិ
pañhapucchakaṃ	បញ្ហបុច្ឆកំ
pañhaṃ	បញ្ហំ
pañhesu	បញ្ហេសុ
pañhākammaṃ	បញ្ហាកម្មំ
pañhāpucchanaṃ	បញ្ហាបុច្ឆនំ
pañhāvārā	បញ្ហាវារា
pañjalikā	បញ្ជលិកា
pañjalī	បញ្ជលី
paññatti	បញ្ញត្តិ
paññattipathānurūpaṃ	បញ្ញត្តិបថានុរូបំ
paññattīsu	បញ្ញត្តីសុ
paññā	បញ្ញា
paññāpāramitā	បញ្ញាបារមិតា
paññāpāramitāya	បញ្ញាបារមិតាយ
paññāpāramiṃ	បញ្ញាបារមិំ
paññāpāramīti	បញ្ញាបារមីតិ
paññāsampadaṃ	បញ្ញាសម្បទំ
paññāsaṃ	បញ្ញាសំ
paññāsādhikāni	បញ្ញាសាធិកានិ
paññāya	បញ្ញាយ
paññāyati	បញ្ញាយតិ
paññāyatīti	បញ្ញាយតីតិ
paññāyittha	បញ្ញាយិត្ថ
paṇḍavapabbatapabbhāre	បណ្ឌវបព្ពតបព្ភារេ
paṇḍita	បណ្ឌិត
paṇḍito	បណ្ឌិតោ
paṇḍitāti	បណ្ឌិតាតិ
paṇḍukambalanāmake	បណ្ឌុកម្ពលនាមកេ
paṇḍukambalasilāsanassa	បណ្ឌុកម្ពលសិលាសនស្ស
paṇḍukambalasilāyaṃ	បណ្ឌុកម្ពលសិលាយំ
paṇṇacchadanaṃ	បណ្ណច្ឆទនំ
paṇṇacchannā	បណ្ណច្ឆន្នា
paṇṇasālaka	បណ្ណសាលក
paṇṇasālakanti	បណ្ណសាលកន្តិ
paṇṇasālakaṃ	បណ្ណសាលកំ
paṇṇasālakuṭidvāraṃ	បណ្ណសាលកុដិទ្វារំ
paṇṇasālato	បណ្ណសាលតោ
paṇṇasālaṃ	បណ្ណសាលំ
paṇṇasālā	បណ្ណសាលា
paṇṇasālāya	បណ្ណសាលាយ
paṇṇasālāyaṃ	បណ្ណសាលាយំ
paṇṇāsa	បណ្ណាស
paṇṇāsahatthubbedhaṃ	បណ្ណាសហត្ថុព្ពេធំ
paṇṇāsasaṅgahādianekavidhaṃ	បណ្ណាសសង្គហាទិអនេកវិធំ
paṭhamabuddhavacanaṃ	បឋមពុទ្ធវចនំ
paṭhamasannipāte	បឋមសន្និបាតេ
paṭhamasannipātoyeva	បឋមសន្និបាតោយេវ
paṭhamataraṃ	បឋមតរំ
paṭhamayāme	បឋមយាមេ
paṭhamaṃ	បឋមំ
paṭhame	បឋមេ
paṭhamo	បឋមោ
paṭhamābhisambuddho	បឋមាភិសម្ពុទ្ធោ
paṭibāhati	បដិពាហតិ
paṭibāhento	បដិពាហេន្តោ
paṭiggahito	បដិគ្គហិតោ
paṭiggaho	បដិគ្គហោ
paṭighaṃ	បដិឃំ
paṭihaññatīti	បដិហញ្ញតីតិ
paṭijaggissāmi	បដិជគ្គិស្សាមិ
paṭijaggitvā	បដិជគ្គិត្វា
paṭikkamanti	បដិក្កមន្តិ
paṭikkamantītiādīsu	បដិក្កមន្តីតិអាទីសុ
paṭikkhipitvā	បដិក្ខិបិត្វា
paṭikkhittesu	បដិក្ខិត្តេសុ
paṭilaggitaṃ	បដិលគ្គិតំ
paṭilome	បដិលោមេ
paṭimuñcitvā	បដិមុញ្ចិត្វា
paṭinivatteti	បដិនិវត្តេតិ
paṭipajji	បដិបជ្ជិ
paṭipajjāhīti	បដិបជ្ជាហីតិ
paṭiparivattitvā	បដិបរិវត្តិត្វា
paṭipuccheyyātha	បដិបុច្ឆេយ្យាថ
paṭipāṭi	បដិបាដិ
paṭisambhidā	បដិសម្ភិទា
paṭisambhidāhi	បដិសម្ភិទាហិ
paṭisambhidāppattassa	បដិសម្ភិទាប្បត្តស្ស
paṭisambhidāvibhaṅgo	បដិសម្ភិទាវិភង្គោ
paṭisandhiṃ	បដិសន្ធិំ
paṭisevato	បដិសេវតោ
paṭititthaṃ	បដិតិត្ថំ
paṭivasati	បដិវសតិ
paṭivedho	បដិវេធោ
paṭividdhadhammaṃ	បដិវិទ្ធធម្មំ
paṭividdhanti	បដិវិទ្ធន្តិ
paṭividdhoti	បដិវិទ្ធោតិ
paṭividdhākuppo	បដិវិទ្ធាកុប្បោ
paṭivijjhanti	បដិវិជ្ឈន្តិ
paṭivijjhantoyeva	បដិវិជ្ឈន្តោយេវ
paṭivijjhi	បដិវិជ្ឈិ
paṭivijjhitabbo	បដិវិជ្ឈិតព្ពោ
paṭivijjhitvā	បដិវិជ្ឈិត្វា
paṭiññaṃ	បដិញ្ញំ
paṭṭhā	បដ្ឋា
paṭṭhānavaraṃ	បដ្ឋានវរំ
paṭṭhānaṃ	បដ្ឋានំ
paṭṭhānāni	បដ្ឋានានិ
paṭṭhānānīti	បដ្ឋានានីតិ
paṭṭhāya	បដ្ឋាយ
pe	បេ
pesetvā	បេសេត្វា
phaggunī	ផគ្គុនី
phalabhārā	ផលភារា
phalamuttame	ផលមុត្តមេ
phalaṃ	ផលំ
phalitā	ផលិតា
phalāphalaṃ	ផលាផលំ
pharasunā	ផរសុនា
pharati	ផរតិ
phareyyuṃ	ផរេយ្យុំ
pharitvā	ផរិត្វា
phariṃsu	ផរិំសុ
phassapaccayā	ផស្សបច្ចយា
phoṭā	ផោដា
phusa	ផុស
phussadevo	ផុស្សទេវោ
phusso	ផុស្សោ
phussā	ផុស្សា
phuṭaṃ	ផុដំ
phāsukaṭṭhānaṃ	ផាសុកដ្ឋានំ
phāsukā	ផាសុកា
phāsuvihāraṃ	ផាសុវិហារំ
phītaṃ	ផីតំ
pipphalīti	បិប្ផលីតិ
pitito	បិតិតោ
pitu	បិតុ
pitucchādhītāya	បិតុច្ឆាធីតាយ
pitupitāmahādayo	បិតុបិតាមហាទយោ
pitā	បិតា
pivatha	បិវថ
piyadassī	បិយទស្សី
piyajālī	បិយជាលី
piyapālo	បិយបាលោ
piyaṃ	បិយំ
piyaṅgurukkho	បិយង្គុរុក្ខោ
piṇḍapātaṃ	បិណ្ឌបាតំ
piṇḍāya	បិណ្ឌាយ
piṭakanti	បិដកន្តិ
piṭakasaddena	បិដកសទ្ទេន
piṭakasampadānenātiādīsu	បិដកសម្បទានេនាតិអាទីសុ
piṭakato	បិដកតោ
piṭakatthavidū	បិដកត្ថវិទូ
piṭakañca	បិដកញ្ច
piṭakañcāti	បិដកញ្ចាតិ
piṭakaṃ	បិដកំ
piṭakesu	បិដកេសុ
piṭakāni	បិដកានិ
potthake	បោត្ថកេ
poṇikanikāyo	បោណិកនិកាយោ
pubbacaritaṃ	បុព្ពចរិតំ
pubbacariyakaṃ	បុព្ពចរិយកំ
pubbakaṃ	បុព្ពកំ
pubbanimittesu	បុព្ពនិមិត្តេសុ
pubbapatthanāvasena	បុព្ពបត្ថនាវសេន
pubbayogo	បុព្ពយោគោ
pubbe	បុព្ពេ
pubbenivāsañāṇaṃ	បុព្ពេនិវាសញាណំ
pucchanti	បុច្ឆន្តិ
pucchati	បុច្ឆតិ
pucchatīti	បុច្ឆតីតិ
pucchi	បុច្ឆិ
pucchitakāle	បុច្ឆិតកាលេ
pucchitamattakeneva	បុច្ឆិតមត្តកេនេវ
pucchitapañhañca	បុច្ឆិតបញ្ហញ្ច
pucchitasuttantā	បុច្ឆិតសុត្តន្តា
pucchiṃsu	បុច្ឆិំសុ
puggalapaññatti	បុគ្គលបញ្ញត្តិ
puggalapaññattiṃ	បុគ្គលបញ្ញត្តិំ
puggalapaññattīti	បុគ្គលបញ្ញត្តីតិ
puggalavāre	បុគ្គលវារេ
puggalo	បុគ្គលោ
puggalā	បុគ្គលា
puna	បុន
punabbhavo	បុនព្ភវោ
punadivase	បុនទិវសេ
punapi	បុនបិ
punappunaṃ	បុនប្បុនំ
punnāgapupphasantharasadisaṃ	បុន្នាគបុប្ផសន្ថរសទិសំ
punāpi	បុនាបិ
pupphadāmaṃ	បុប្ផទាមំ
pupphanti	បុប្ផន្តិ
pupphasu	បុប្ផសុ
pupphavitānaṃ	បុប្ផវិតានំ
pupphaṃ	បុប្ផំ
pupphehi	បុប្ផេហិ
pupphino	បុប្ផិនោ
pupphito	បុប្ផិតោ
pupphitā	បុប្ផិតា
pupphitānaṃ	បុប្ផិតានំ
pupphā	បុប្ផា
pupphāni	បុប្ផានិ
pupphūpagaphalūpagarukkhasañchannaṃ	បុប្ផូបគផលូបគរុក្ខសញ្ឆន្នំ
purato	បុរតោ
purejātapaccayo	បុរេជាតបច្ចយោ
purimā	បុរិមា
purisaṃ	បុរិសំ
purisena	បុរិសេន
puriso	បុរិសោ
purisuttame	បុរិសុត្តមេ
purā	បុរា
puthujjanakalyāṇā	បុថុជ្ជនកល្យាណា
puttaketi	បុត្តកេតិ
puttasinehassa	បុត្តសិនេហស្ស
puññakamminaṃ	បុញ្ញកម្មិនំ
puññakoṭṭhāsaṃ	បុញ្ញកោដ្ឋាសំ
puññāni	បុញ្ញានិ
puññānubhāvena	បុញ្ញានុភាវេន
puṇḍarīkarukkho	បុណ្ឌរីករុក្ខោ
puṇṇacandasassirīkaṃ	បុណ្ណចន្ទសស្សិរីកំ
puṇṇamano	បុណ្ណមនោ
puṭṭhā	បុដ្ឋា
pāci	បាចិ
pācīnadisābhimukho	បាចីនទិសាភិមុខោ
pādamuddhari	បាទមុទ្ធរិ
pāde	បាទេ
pādesu	បាទេសុ
pādā	បាទា
pākaṭaṃ	បាកដំ
pākaṭo	បាកដោ
pākaṭā	បាកដា
pākaṭāpe	បាកដាបេ
pālito	បាលិតោ
pāmojjena	បាមោជ្ជេន
pānīyaghaṭapānīyasaṅkhapānīyasarāvāni	បានីយឃដបានីយសង្ខបានីយសរាវានិ
pāpakaṃ	បាបកំ
pāpake	បាបកេ
pāpaṃ	បាបំ
pāpe	បាបេ
pāpetuṃ	បាបេតុំ
pāpetvā	បាបេត្វា
pāpuṇi	បាបុណិ
pāpuṇinti	បាបុណិន្តិ
pāpuṇissasi	បាបុណិស្សសិ
pāpuṇissatīti	បាបុណិស្សតីតិ
pāpuṇitvā	បាបុណិត្វា
pāpuṇāti	បាបុណាតិ
pāpuṇātīti	បាបុណាតីតិ
pāragū	បារគូ
pāramiyo	បារមិយោ
pāramiṃ	បារមិំ
pāraṅgato	បារង្គតោ
pāricchattakamūle	បារិច្ឆត្តកមូលេ
pārichattakaṃ	បារិឆត្តកំ
pārupitvā	បារុបិត្វា
pāsādesu	បាសាទេសុ
pāsādiko	បាសាទិកោ
pātimokkhāni	បាតិមោក្ខានិ
pāto	បាតោ
pātova	បាតោវ
pātubhavanti	បាតុភវន្តិ
pāturahesuṃ	បាតុរហេសុំ
pāturahosi	បាតុរហោសិ
pāvacanaṃ	បាវចនំ
pāvisi	បាវិសិ
pāvisī	បាវិសី
pāyesi	បាយេសិ
pāyāsaṃ	បាយាសំ
pāḷiyā	បាឡិយា
pāṇe	បាណេ
pāṇā	បាណា
pāṭalirukkho	បាដលិរុក្ខោ
pāṭiyaputtasamāgame	បាដិយបុត្តសមាគមេ
pītarasmiyo	បីតរស្មិយោ
pītaṭṭhānehi	បីតដ្ឋានេហិ
pīti	បីតិ
pītisomanassajāto	បីតិសោមនស្សជាតោ
pītisomanassaṃ	បីតិសោមនស្សំ
pītisukheneva	បីតិសុខេនេវ
pītiyā	បីតិយា
pītiṃ	បីតិំ
pītiṃavijahitvā	បីតិំអវិជហិត្វា
pīḷetvā	បីឡេត្វា
pīḷitaṃ	បីឡិតំ
pūjamakāsi	បូជមកាសិ
pūjesi	បូជេសិ
pūjetvā	បូជេត្វា
pūjite	បូជិតេ
pūjitā	បូជិតា
pūjitāpi	បូជិតាបិ
pūjārahāti	បូជារហាតិ
pūrayuṃ	បូរយុំ
pūrehi	បូរេហិ
pūrentassa	បូរេន្តស្ស
pūrenti	បូរេន្តិ
pūrento	បូរេន្តោ
pūresi	បូរេសិ
pūretvā	បូរេត្វា
pūritapāramibhāvaṃ	បូរិតបារមិភាវំ
pūritattabhāvānaṃ	បូរិតត្តភាវានំ
pūritaṃ	បូរិតំ
pūrāpetvā	បូរាបេត្វា
pūtikāyaṃ	បូតិកាយំ
rajataghaṭehi	រជតឃដេហិ
rajatamayesu	រជតមយេសុ
rajatamayā	រជតមយា
rajatavaṇṇā	រជតវណ្ណា
rajitabbo	រជិតព្ពោ
rajjasiriṃ	រជ្ជសិរិំ
rajjaṃ	រជ្ជំ
rajjena	រជ្ជេន
rajomalaṃ	រជោមលំ
rakkhantaṃ	រក្ខន្តំ
rakkhati	រក្ខតិ
rakkhatīti	រក្ខតីតិ
ramaṇīyaṃ	រមណីយំ
rammavatī	រម្មវតី
rammā	រម្មា
ramāmi	រមាមិ
rasmiyo	រស្មិយោ
rasmiādīsu	រស្មិអាទីសុ
rasmīsu	រស្មីសុ
ratanagharanti	រតនឃរន្តិ
ratanagharasattāhe	រតនឃរសត្តាហេ
ratanagharaṃ	រតនឃរំ
ratanaghare	រតនឃរេ
ratanamattaanucaṅkamaṃ	រតនមត្តអនុចង្កមំ
ratanamattamakulaṃ	រតនមត្តមកុលំ
ratanattaye	រតនត្តយេ
ratanehi	រតនេហិ
ratanike	រតនិកេ
ratanā	រតនា
ratanāvaliṃ	រតនាវលិំ
rattakambalaparikkhittā	រត្តកម្ពលបរិក្ខិត្តា
rattavākacīraṃ	រត្តវាកចីរំ
rattaṅkurarukkho	រត្តង្កុររុក្ខោ
rattaṭṭhānehi	រត្តដ្ឋានេហិ
rattikkhaye	រត្តិក្ខយេ
rattindivaparicchedaṃ	រត្តិន្ទិវបរិច្ឆេទំ
rattindivaparicchedo	រត្តិន្ទិវបរិច្ឆេទោ
rattindivāni	រត្តិន្ទិវានិ
rattiyo	រត្តិយោ
rattāvasesena	រត្តាវសេសេន
ravanakasakuṇānañca	រវនកសកុណានញ្ច
ravati	រវតិ
rañño	រញ្ញោ
raṭṭhapīḷanakilesābhāvo	រដ្ឋបីឡនកិលេសាភាវោ
raṭṭhaṃ	រដ្ឋំ
raṭṭhuppādaṃ	រដ្ឋុប្បាទំ
revato	រេវតោ
revatoti	រេវតោតិ
rittā	រិត្តា
rogo	រោគោ
ropissaṃ	រោបិស្សំ
ropitaṃ	រោបិតំ
ruciṃ	រុចិំ
rujjanti	រុជ្ជន្តិ
rukkhamūlasenāsanassa	រុក្ខមូលសេនាសនស្ស
rukkhamūlaṃ	រុក្ខមូលំ
rukkhe	រុក្ខេ
rukkhā	រុក្ខា
rāgaṃ	រាគំ
rāgādipaṭipakkhabhūto	រាគាទិបដិបក្ខភូតោ
rāgānusayānanti	រាគានុសយានន្តិ
rāhulabhaddassa	រាហុលភទ្ទស្ស
rājagahaṃ	រាជគហំ
rājagahe	រាជគហេ
rājakulesu	រាជកុលេសុ
rājakumāresu	រាជកុមារេសុ
rājakumāro	រាជកុមារោ
rājarājamahāmaccehi	រាជរាជមហាមច្ចេហិ
rājā	រាជា
rāmā	រាមា
rāsivaḍḍhako	រាសិវឌ្ឍកោ
rūpagataṃva	រូបគតំវ
rūpakkhandho	រូបក្ខន្ធោ
rūpavibhatti	រូបវិភត្តិ
rūpañca	រូបញ្ច
rūpaṃ	រូបំ
rūpārūpadhamme	រូបារូបធម្មេ
rūpārūpaparicchedaṃ	រូបារូបបរិច្ឆេទំ
rūpāvacarakusalato	រូបាវចរកុសលតោ
rūpūpapattiyā	រូបូបបត្តិយា
sa	ស
sabbabhave	សព្ពភវេ
sabbabhikkhūnaṃ	សព្ពភិក្ខូនំ
sabbadassī	សព្ពទស្សី
sabbadā	សព្ពទា
sabbakammamupāgataṃ	សព្ពកម្មមុបាគតំ
sabbakathāmaggesu	សព្ពកថាមគ្គេសុ
sabbakilese	សព្ពកិលេសេ
sabbakālaṃ	សព្ពកាលំ
sabbakāmo	សព្ពកាមោ
sabbamitto	សព្ពមិត្តោ
sabbampetaṃ	សព្ពម្បេតំ
sabbampi	សព្ពម្បិ
sabbanāmā	សព្ពនាមា
sabbapāramīti	សព្ពបារមីតិ
sabbasattānaṃ	សព្ពសត្តានំ
sabbasaṅkhārāti	សព្ពសង្ខារាតិ
sabbaso	សព្ពសោ
sabbasāmayikaparisāya	សព្ពសាមយិកបរិសាយ
sabbattha	សព្ពត្ថ
sabbaññubuddhena	សព្ពញ្ញុពុទ្ធេន
sabbaññubuddhānaṃyeva	សព្ពញ្ញុពុទ្ធានំយេវ
sabbaññubuddhāva	សព្ពញ្ញុពុទ្ធាវ
sabbaññutaññāṇaṃ	សព្ពញ្ញុតញ្ញាណំ
sabbaññutaññāṇena	សព្ពញ្ញុតញ្ញាណេន
sabbaññutaññāṇeneva	សព្ពញ្ញុតញ្ញាណេនេវ
sabbaññutaṃ	សព្ពញ្ញុតំ
sabbaṃ	សព្ពំ
sabbaṅgasampannaṃ	សព្ពង្គសម្បន្នំ
sabbaṅgasampannā	សព្ពង្គសម្បន្នា
sabbe	សព្ពេ
sabbehipi	សព្ពេហិបិ
sabbepi	សព្ពេបិ
sabbesaṃ	សព្ពេសំ
sabbesu	សព្ពេសុ
sabbeva	សព្ពេវ
sabbā	សព្ពា
sabbāni	សព្ពានិ
sabhiyo	សភិយោ
sabhāvaparicchinnattā	សភាវបរិច្ឆិន្នត្តា
sabhāvarasalakkhaṇe	សភាវរសលក្ខណេ
saccamanurakkhantassa	សច្ចមនុរក្ខន្តស្ស
saccapadeso	សច្ចបទេសោ
saccapaññatti	សច្ចបញ្ញត្តិ
saccapāramitā	សច្ចបារមិតា
saccapāramiṃ	សច្ចបារមិំ
saccapāramīti	សច្ចបារមីតិ
saccavibhaṅgo	សច្ចវិភង្គោ
saccayamakaṃ	សច្ចយមកំ
saccesu	សច្ចេសុ
sacchikatanirodho	សច្ឆិកតនិរោធោ
sacchikatenidha	សច្ឆិកតេនិធ
saccikaṭṭhaparamatthenāti	សច្ចិកដ្ឋបរមត្ថេនាតិ
saccikaṭṭho	សច្ចិកដ្ឋោ
saccāni	សច្ចានិ
sace	សចេ
sacīvaraṃ	សចីវរំ
saddehi	សទ្ទេហិ
saddhammaṃ	សទ្ធម្មំ
saddhammo	សទ្ធម្មោ
saddhivihārikānaṃ	សទ្ធិវិហារិកានំ
saddhiṃ	សទ្ធិំ
saddhāsampannānaṃ	សទ្ធាសម្បន្នានំ
saddārammaṇaṃ	សទ្ទារម្មណំ
sadevakaṃ	សទេវកំ
sadevake	សទេវកេ
sadevakā	សទេវកា
sadhamme	សធម្មេ
sadā	សទា
saggesu	សគ្គេសុ
saggā	សគ្គា
sagāthakaṃ	សគាថកំ
sagāthāvaggo	សគាថាវគ្គោ
saha	សហ
sahadhammikaṃ	សហធម្មិកំ
sahajātapaccayo	សហជាតបច្ចយោ
sahampatibrahmunā	សហម្បតិព្រហ្មុនា
sahassabhāgena	សហស្សភាគេន
sahassavaṭṭiyo	សហស្សវដ្ដិយោ
sahassāni	សហស្សានិ
sahati	សហតិ
sahatthā	សហត្ថា
sahaṃ	សហំ
sahetudhammaṃ	សហេតុធម្មំ
sahetusambhavaṃ	សហេតុសម្ភវំ
sajjhāyantānaṃ	សជ្ឈាយន្តានំ
sajjitaṃ	សជ្ជិតំ
sakalampetaṃ	សកលម្បេតំ
sakalampi	សកលម្បិ
sakalarattiṃ	សកលរត្តិំ
sakalasarīraṃ	សកលសរីរំ
sakalaṃ	សកលំ
sakalopi	សកលោបិ
sakalāyapi	សកលាយបិ
sakassamā	សកស្សមា
sakattānaṃ	សកត្តានំ
sakavāde	សកវាទេ
sakaṭṭhāneva	សកដ្ឋានេវ
sakhilā	សខិលា
sakhuraṃ	សខុរំ
sakkaccaṃ	សក្កច្ចំ
sakkadattiyaṃ	សក្កទត្តិយំ
sakkassa	សក្កស្ស
sakkena	សក្កេន
sakkhissathāti	សក្ខិស្សថាតិ
sakko	សក្កោ
sakkomi	សក្កោមិ
sakkoti	សក្កោតិ
sakkotīti	សក្កោតីតិ
sakkā	សក្កា
sakkāti	សក្កាតិ
sakyarājakule	សក្យរាជកុលេ
sakāsayā	សកាសយា
salakkhaṇasaṅkhāto	សលក្ខណសង្ខាតោ
salakkhaṇā	សលក្ខណា
salakkhaṇāpi	សលក្ខណាបិ
salalarukkho	សលលរុក្ខោ
salalaṃ	សលលំ
sallahukabhāvo	សល្លហុកភាវោ
sallakkhesi	សល្លក្ខេសិ
sallakkhetvā	សល្លក្ខេត្វា
samabhavīti	សមភវីតិ
samanantarapaccayo	សមនន្តរបច្ចយោ
samannāgataṃ	សមន្នាគតំ
samannāgato	សមន្នាគតោ
samantapaṭṭhānassa	សមន្តបដ្ឋានស្ស
samantapaṭṭhāne	សមន្តបដ្ឋានេ
samantato	សមន្តតោ
samantā	សមន្តា
samanupassāmi	សមនុបស្សាមិ
samatalaṃ	សមតលំ
samatalo	សមតលោ
samavippakiṇṇavālukaṃ	សមវិប្បកិណ្ណវាលុកំ
samayaṃ	សមយំ
samaye	សមយេ
samayena	សមយេន
samaṃ	សមំ
samaṅgo	សមង្គោ
samaṇadhammaṃ	សមណធម្មំ
samaṇasukhehi	សមណសុខេហិ
samaṇasukhāni	សមណសុខានិ
sambalo	សម្ពលោ
sambhavo	សម្ភវោ
sambodhiṃ	សម្ពោធិំ
sambuddhassa	សម្ពុទ្ធស្ស
sambuddhā	សម្ពុទ្ធា
sameti	សមេតិ
samijjhatīti	សមិជ្ឈតីតិ
samiṃsu	សមិំសុ
sammappadhāna	សម្មប្បធាន
sammappadhānavibhaṅgo	សម្មប្បធានវិភង្គោ
sammappadhānāni	សម្មប្បធានានិ
sammasanaṃ	សម្មសនំ
sammasantassa	សម្មសន្តស្ស
sammasantassāpi	សម្មសន្តស្សាបិ
sammasati	សម្មសតិ
sammasato	សម្មសតោ
sammasi	សម្មសិ
sammasitadhammo	សម្មសិតធម្មោ
sammasitaṭṭhānaṃ	សម្មសិតដ្ឋានំ
sammaṭṭhampi	សម្មដ្ឋម្បិ
sammukhā	សម្មុខា
sammā	សម្មា
sammānāvamānakkhamo	សម្មានាវមានក្ខមោ
sammāsambuddhassa	សម្មាសម្ពុទ្ធស្ស
sammāsambuddhaṃ	សម្មាសម្ពុទ្ធំ
sammāsambuddhe	សម្មាសម្ពុទ្ធេ
sammāsambuddho	សម្មាសម្ពុទ្ធោ
samo	សមោ
samodhānetvā	សមោធានេត្វា
sampajjati	សម្បជ្ជតិ
sampajāno	សម្បជានោ
sampakampi	សម្បកម្បិ
sampasāritamecakapaṭaṃ	សម្បសារិតមេចកបដំ
sampasāritarajatapaṭṭavitānā	សម្បសារិតរជតបដ្ដវិតានា
sampattagāme	សម្បត្តគាមេ
sampattaparisāya	សម្បត្តបរិសាយ
sampattiṃ	សម្បត្តិំ
sampattānaṃ	សម្បត្តានំ
sampavattayi	សម្បវត្តយិ
sampavedhi	សម្បវេធិ
sampayogo	សម្បយោគោ
sampayuttapaccayo	សម្បយុត្តបច្ចយោ
sampayuttaṃ	សម្បយុត្តំ
sampayuttena	សម្បយុត្តេន
sampaṭicchitvā	សម្បដិច្ឆិត្វា
sampuṇṇo	សម្បុណ្ណោ
sampādethāti	សម្បាទេថាតិ
sampāpuṇeyya	សម្បាបុណេយ្យ
sampāpuṇāti	សម្បាបុណាតិ
samudayasaccaṃ	សមុទយសច្ចំ
samuddā	សមុទ្ទា
samudācarante	សមុទាចរន្តេ
samudācaranti	សមុទាចរន្តិ
samudācārena	សមុទាចារេន
samussitasuvaṇṇakkhandho	សមុស្សិតសុវណ្ណក្ខន្ធោ
samussitesu	សមុស្សិតេសុ
samussāhitamānaso	សមុស្សាហិតមានសោ
samā	សមា
samācikkhi	សមាចិក្ខិ
samādhisampadaṃ	សមាធិសម្បទំ
samādhissa	សមាធិស្ស
samādiya	សមាទិយ
samāgamma	សមាគម្ម
samāgamo	សមាគមោ
samāgantvā	សមាគន្ត្វា
samāhitā	សមាហិតា
samālā	សមាលា
samānakathā	សមានកថា
samānaṃ	សមានំ
samānenti	សមានេន្តិ
samānetabbaṃ	សមានេតព្ពំ
samāpattiyo	សមាបត្តិយោ
samāpattīnañca	សមាបត្តីនញ្ច
samāpattīsu	សមាបត្តីសុ
samāruyha	សមារុយ្ហ
samāsaṃ	សមាសំ
samūhato	សមូហតោ
sandanti	សន្ទន្តិ
sandeho	សន្ទេហោ
sandhāvissaṃ	សន្ធាវិស្សំ
sandhāya	សន្ធាយ
sandissamānaṃ	សន្ទិស្សមានំ
sandissati	សន្ទិស្សតិ
sannipatitesu	សន្និបតិតេសុ
sannisinno	សន្និសិន្នោ
santacittā	សន្តចិត្តា
santakaṃ	សន្តកំ
santakāti	សន្តកាតិ
sante	សន្តេ
santhambhetīti	សន្ថម្ភេតីតិ
santharitvā	សន្ថរិត្វា
santikaṃ	សន្តិកំ
santike	សន្តិកេ
santikenidānanti	សន្តិកេនិទានន្តិ
santikenidānaṃ	សន្តិកេនិទានំ
santo	សន្តោ
santusito	សន្តុសិតោ
santuṭṭhā	សន្តុដ្ឋា
santāressaṃ	សន្តារេស្សំ
santāretvā	សន្តារេត្វា
sapattacīvaraṃ	សបត្តចីវរំ
sappaṃ	សប្បំ
sappinavanītatelamadhuphāṇitānaṃ	សប្បិនវនីតតេលមធុផាណិតានំ
sappissa	សប្បិស្ស
sappurisā	សប្បុរិសា
sappītikabhāvo	សប្បីតិកភាវោ
saputtadāro	សបុត្តទារោ
sarakutti	សរកុត្តិ
saraṇadukā	សរណទុកា
saraṇamakaṃsu	សរណមកំសុ
saraṇaṃ	សរណំ
saraṇesu	សរណេសុ
saraṇo	សរណោ
saraṇā	សរណា
sare	សរេ
saresu	សរេសុ
saro	សរោ
sarīrappabhā	សរីរប្បភា
sarīrappadesā	សរីរប្បទេសា
sarīrassa	សរីរស្ស
sarīrato	សរីរតោ
sarīraṃ	សរីរំ
sarīre	សរីរេ
sarīresu	សរីរេសុ
sarīrobhāso	សរីរោភាសោ
sasapaṇḍitajātakāle	សសបណ្ឌិតជាតកាលេ
sasaṅghaṃ	សសង្ឃំ
sasaṅghe	សសង្ឃេ
sassamiva	សស្សមិវ
sasādīhi	សសាទីហិ
sasāvako	សសាវកោ
satabhāgena	សតភាគេន
satakoṭiyo	សតកោដិយោ
satasahassabhāgena	សតសហស្សភាគេន
satasahassagghanikaṃ	សតសហស្សគ្ឃនិកំ
satasahassagghanikā	សតសហស្សគ្ឃនិកា
satasahassakappamatthake	សតសហស្សកប្បមត្ថកេ
satasahasse	សតសហស្សេ
satasahassehi	សតសហស្សេហិ
satasahassepi	សតសហស្សេបិ
satasahassāni	សតសហស្សានិ
sataṃ	សតំ
sati	សតិ
satipaṭṭhānapadeso	សតិបដ្ឋានបទេសោ
satipaṭṭhānavibhaṅgo	សតិបដ្ឋានវិភង្គោ
satipaṭṭhāne	សតិបដ្ឋានេ
satipaṭṭhānā	សតិបដ្ឋានា
sato	សតោ
satta	សត្ត
sattahi	សត្តហិ
sattahivassasahassāni	សត្តហិវស្សសហស្សានិ
sattakkhattuṃ	សត្តក្ខត្តុំ
sattamaṃ	សត្តមំ
sattamo	សត្តមោ
sattamā	សត្តមា
sattannaṃ	សត្តន្នំ
sattapaññāsañca	សត្តបញ្ញាសញ្ច
sattappakaraṇauggahaṇañca	សត្តប្បករណឧគ្គហណញ្ច
sattappakaraṇāni	សត្តប្បករណានិ
sattaratanakhacitaṃ	សត្តរតនខចិតំ
sattaratanamayaṃ	សត្តរតនមយំ
sattaratanamayesu	សត្តរតនមយេសុ
sattaratanamayo	សត្តរតនមយោ
sattaratanamayāva	សត្តរតនមយាវ
sattaratanapaṭimaṇḍitaṃ	សត្តរតនបដិមណ្ឌិតំ
sattati	សត្តតិ
sattatihatthubbedhaṃ	សត្តតិហត្ថុព្ពេធំ
sattatikappasahassāni	សត្តតិកប្បសហស្សានិ
sattesu	សត្តេសុ
satthu	សត្ថុ
satthuno	សត្ថុនោ
satthā	សត្ថា
satthāradassanaṃ	សត្ថារទស្សនំ
satthāraṃ	សត្ថារំ
satthārā	សត្ថារា
satthāti	សត្ថាតិ
sattihi	សត្តិហិ
sattubhastajātake	សត្តុភស្តជាតកេ
sattā	សត្តា
sattāhabbhantareyeva	សត្តាហព្ភន្តរេយេវ
sattāhaccayena	សត្តាហច្ចយេន
sattāhaṃ	សត្តាហំ
sattāhe	សត្តាហេ
sattāhāni	សត្តាហានិ
sattānaṃ	សត្តានំ
sattāti	សត្តាតិ
satā	សតា
savanatotha	សវនតោថ
savantiyo	សវន្តិយោ
sayambhūñāṇādhigamena	សយម្ភូញាណាធិគមេន
sayaṃvasī	សយំវសី
sañcarittapeyyālaṃ	សញ្ចរិត្តបេយ្យាលំ
sañjātappamodā	សញ្ជាតប្បមោទា
sañjātasaṃvego	សញ្ជាតសំវេគោ
sañjīvo	សញ្ជីវោ
saññino	សញ្ញិនោ
saññāpesi	សញ្ញាបេសិ
saññāpetvā	សញ្ញាបេត្វា
saṃ	សំ
saṃharitvā	សំហរិត្វា
saṃsandiyamānaṃ	សំសន្ទិយមានំ
saṃsuddhagahaṇiko	សំសុទ្ធគហណិកោ
saṃsādenti	សំសាទេន្តិ
saṃsārasāgaro	សំសារសាគរោ
saṃsāravaṭṭaṃ	សំសារវដ្ដំ
saṃsāroti	សំសារោតិ
saṃvarāsaṃvaradiṭṭhiviniveṭhananāmarūpaparicchedakathāti	សំវរាសំវរទិដ្ឋិវិនិវេឋននាមរូបបរិច្ឆេទកថាតិ
saṃvarāsaṃvarakathā	សំវរាសំវរកថា
saṃvarāsaṃvaro	សំវរាសំវរោ
saṃvarāsaṃvaroti	សំវរាសំវរោតិ
saṃvattanti	សំវត្តន្តិ
saṃvattati	សំវត្តតិ
saṃvaṇṇitā	សំវណ្ណិតា
saṃvegajātāhi	សំវេគជាតាហិ
saṃvidhāya	សំវិធាយ
saṃviggamānaso	សំវិគ្គមានសោ
saṃvijjamānā	សំវិជ្ជមានា
saṃyuttaaṅguttarikadvemahānikāyappamāṇāva	សំយុត្តអង្គុត្តរិកទ្វេមហានិកាយប្បមាណាវ
saṃyuttanikāye	សំយុត្តនិកាយេ
saṃyuttanikāyo	សំយុត្តនិកាយោ
saṃyuttasaṅgaho	សំយុត្តសង្គហោ
saṅgahappabhedaṃ	សង្គហប្បភេទំ
saṅgahitaṃ	សង្គហិតំ
saṅgahitena	សង្គហិតេន
saṅgahitā	សង្គហិតា
saṅgahitāni	សង្គហិតានិ
saṅgaho	សង្គហោ
saṅgayhamānaṃ	សង្គយ្ហមានំ
saṅghassa	សង្ឃស្ស
saṅghaṃ	សង្ឃំ
saṅghe	សង្ឃេ
saṅghārāmaṃ	សង្ឃារាមំ
saṅgāyantena	សង្គាយន្តេន
saṅgītaṃ	សង្គីតំ
saṅgīte	សង្គីតេ
saṅgītiāropitanayena	សង្គីតិអារោបិតនយេន
saṅgīto	សង្គីតោ
saṅkamitvā	សង្កមិត្វា
saṅkamitvāva	សង្កមិត្វាវ
saṅkampi	សង្កម្បិ
saṅkhabrāhmaṇakāle	សង្ខព្រាហ្មណកាលេ
saṅkhapālajātakāle	សង្ខបាលជាតកាលេ
saṅkhepo	សង្ខេបោ
saṅkhyaṃ	សង្ខ្យំ
saṅkhyā	សង្ខ្យា
saṅkhārayamakaṃ	សង្ខារយមកំ
saṅkhārā	សង្ខារា
saṇhasukhumadhammaṃ	សណ្ហសុខុមធម្មំ
saṇikaṃ	សណិកំ
saṇṭhahatīti	សណ្ឋហតីតិ
saṭṭhi	សដ្ឋិ
saṭṭhibhikkhusatasahassāni	សដ្ឋិភិក្ខុសតសហស្សានិ
saṭṭhihatthaṃ	សដ្ឋិហត្ថំ
saṭṭhihatthe	សដ្ឋិហត្ថេ
saṭṭhihatthubbedhaṃ	សដ្ឋិហត្ថុព្ពេធំ
saṭṭhivassasahassāni	សដ្ឋិវស្សសហស្សានិ
saṭṭhivassasahassānīti	សដ្ឋិវស្សសហស្សានីតិ
saṭṭhivassikattherā	សដ្ឋិវស្សិកត្ថេរា
sedā	សេទា
sekhā	សេខា
sekkhā	សេក្ខា
selamayaṃ	សេលមយំ
selo	សេលោ
selā	សេលា
senakapaṇḍitakāle	សេនកបណ្ឌិតកាលេ
senānigame	សេនានិគមេ
senāsanaṃ	សេនាសនំ
serī	សេរី
sesi	សេសិ
sesānampi	សេសានម្បិ
setabhittiyo	សេតភិត្តិយោ
setaṭṭhānehi	សេតដ្ឋានេហិ
sevanti	សេវន្តិ
seyyathāpi	សេយ្យថាបិ
seyyaṃ	សេយ្យំ
sibbitabbābhāvo	សិព្ពិតព្ពាភាវោ
siddhatthassa	សិទ្ធត្ថស្ស
siddhattho	សិទ្ធត្ថោ
siddhippattassa	សិទ្ធិប្បត្តស្ស
siggavo	សិគ្គវោ
sikhī	សិខី
sikkhanti	សិក្ខន្តិ
sikkhantī	សិក្ខន្តី
sikkhitasikkhā	សិក្ខិតសិក្ខា
sikkhā	សិក្ខា
sikkhāpadapaññāpanaṃ	សិក្ខាបទបញ្ញាបនំ
sikkhāpadavibhaṅge	សិក្ខាបទវិភង្គេ
sikkhāpadavibhaṅgo	សិក្ខាបទវិភង្គោ
sikkhāpadāni	សិក្ខាបទានិ
sikkāya	សិក្កាយ
siliṭṭhaṃ	សិលិដ្ឋំ
sineruṃ	សិនេរុំ
siniddhāhāro	សិនិទ្ធាហារោ
sirasmiṃ	សិរស្មិំ
sirimā	សិរិមា
sirisayane	សិរិសយនេ
siriyā	សិរិយា
sirīmato	សិរីមតោ
sissehi	សិស្សេហិ
sissānusissasaṅkhātāya	សិស្សានុសិស្សសង្ខាតាយ
sissānusissehīti	សិស្សានុសិស្សេហីតិ
sivamañjase	សិវមញ្ជសេ
sive	សិវេ
sivijātake	សិវិជាតកេ
sivirājakāle	សិវិរាជកាលេ
siyā	សិយា
so	សោ
sobhati	សោភតិ
sobhavatī	សោភវតី
sobhaṇaṃ	សោភណំ
sobhesi	សោភេសិ
sobheyyāti	សោភេយ្យាតិ
sobhito	សោភិតោ
sodhayissāmi	សោធយិស្សាមិ
sodhemahaṃ	សោធេមហំ
sodhenti	សោធេន្តិ
sodhetha	សោធេថ
sodhetuṃ	សោធេតុំ
sodhīyati	សោធីយតិ
soko	សោកោ
somanassakumārakāle	សោមនស្សកុមារកាលេ
somanassaṃ	សោមនស្សំ
sopi	សោបិ
sosetvā	សោសេត្វា
sotthijo	សោត្ថិជោ
sotthiyena	សោត្ថិយេន
sotthiṃ	សោត្ថិំ
sotukāmaṃ	សោតុកាមំ
sotūnaṃ	សោតូនំ
sovaṇṇamayaṃ	សោវណ្ណមយំ
soḷasa	សោឡស
soṇako	សោណកោ
soṇarukkho	សោណរុក្ខោ
soṇo	សោណោ
soṇā	សោណា
su	សុ
subhaddo	សុភទ្ទោ
subhaddā	សុភទ្ទា
sucimpi	សុចិម្បិ
suciṃ	សុចិំ
suciṇṇe	សុចិណ្ណេ
suciṇṇo	សុចិណ្ណោ
sudassananagare	សុទស្សននគរេ
sudassanasiluccaye	សុទស្សនសិលុច្ចយេ
sudassanaṃ	សុទស្សនំ
sudassano	សុទស្សនោ
sudassanā	សុទស្សនា
sudatto	សុទត្តោ
sudattā	សុទត្តា
suddhagocarā	សុទ្ធគោចរា
suddhikagāthā	សុទ្ធិកគាថា
suddhodano	សុទ្ធោទនោ
suddhāvāse	សុទ្ធាវាសេ
sudevo	សុទេវោ
sudhammaṃ	សុធម្មំ
sudhammo	សុធម្មោ
sudhammā	សុធម្មា
sudhaññavatī	សុធញ្ញវតី
sudinnaṃ	សុទិន្នំ
sudinno	សុទិន្នោ
sudubbudhaṃ	សុទុព្ពុធំ
sugambhīrāti	សុគម្ភីរាតិ
suggahitā	សុគ្គហិតា
suguttaṃ	សុគុត្តំ
sujāto	សុជាតោ
sujātā	សុជាតា
sujātāya	សុជាតាយ
sukathitaṃ	សុកថិតំ
sukato	សុកតោ
sukhadukkhaṃ	សុខទុក្ខំ
sukhadukkhe	សុខទុក្ខេ
sukhamāvahāti	សុខមាវហាតិ
sukhaṃ	សុខំ
sukhena	សុខេន
sukhito	សុខិតោ
sukhumālakaraṇabhāvo	សុខុមាលករណភាវោ
sukhāya	សុខាយ
sukhī	សុខី
sulabhatāya	សុលភតាយ
sumanadevatthero	សុមនទេវត្ថេរោ
sumano	សុមនោ
sumanā	សុមនា
sumaṅgalaṃ	សុមង្គលំ
sumedhakathā	សុមេធកថា
sumedhapaṇḍitena	សុមេធបណ្ឌិតេន
sumedhapaṇḍito	សុមេធបណ្ឌិតោ
sumedho	សុមេធោ
sumitto	សុមិត្តោ
sumāpitā	សុមាបិតា
sunando	សុនន្ទោ
sunandā	សុនន្ទា
sundaraṃ	សុន្ទរំ
sundarī	សុន្ទរី
sunetto	សុនេត្តោ
supaccakkho	សុបច្ចក្ខោ
supakkalākhārasasiñcamānā	សុបក្កលាខារសសិញ្ចមានា
suparicchinno	សុបរិច្ឆិន្នោ
suphassā	សុផស្សា
suphusitaṃ	សុផុសិតំ
suppatiṭṭhito	សុប្បតិដ្ឋិតោ
suppatīto	សុប្បតីតោ
suppaṭipanno	សុប្បដិបន្នោ
supupphitasatapattasassirikaṃ	សុបុប្ផិតសតបត្តសស្សិរិកំ
surakkhito	សុរក្ខិតោ
surattadupaṭṭaṃ	សុរត្តទុបដ្ដំ
suruci	សុរុចិ
surāmā	សុរាមា
susīmo	សុសីមោ
sutta	សុត្ត
suttanipāte	សុត្តនិបាតេ
suttantabhājanīyaabhidhammabhājanīyapañhapucchakanayānaṃ	សុត្តន្តភាជនីយអភិធម្មភាជនីយបញ្ហបុច្ឆកនយានំ
suttantabhājanīyaabhidhammabhājanīyapañhapucchakānaṃ	សុត្តន្តភាជនីយអភិធម្មភាជនីយបញ្ហបុច្ឆកានំ
suttantabhājanīyaṃ	សុត្តន្តភាជនីយំ
suttantapiṭakaṃ	សុត្តន្តបិដកំ
suttantapiṭake	សុត្តន្តបិដកេ
suttantañca	សុត្តន្តញ្ច
suttantaṃ	សុត្តន្តំ
suttanti	សុត្តន្តិ
suttantikadukā	សុត្តន្តិកទុកា
suttantā	សុត្តន្តា
suttanāmakaṃ	សុត្តនាមកំ
suttapadānañceva	សុត្តបទានញ្ចេវ
suttasabhāgato	សុត្តសភាគតោ
suttasahassaṃ	សុត្តសហស្សំ
suttasahassesu	សុត្តសហស្សេសុ
suttasahassāni	សុត្តសហស្សានិ
suttasatāni	សុត្តសតានិ
suttaṃ	សុត្តំ
suttaṃpe	សុត្តំបេ
suttena	សុត្តេន
suttesu	សុត្តេសុ
suttādīni	សុត្តាទីនិ
suttānaṃ	សុត្តានំ
suttāni	សុត្តានិ
sutvā	សុត្វា
sutvāna	សុត្វាន
suvavatthito	សុវវត្ថិតោ
suvaṇṇakalasehi	សុវណ្ណកលសេហិ
suvaṇṇamayesu	សុវណ្ណមយេសុ
suvaṇṇamayā	សុវណ្ណមយា
suvaṇṇapaṭa	សុវណ្ណបដ
suvaṇṇapaṭapasāritā	សុវណ្ណបដបសារិតា
suvaṇṇapaṭimā	សុវណ្ណបដិមា
suvaṇṇapādukañca	សុវណ្ណបាទុកញ្ច
suvaṇṇapātiṃ	សុវណ្ណបាតិំ
suvaṇṇarajatamaṇimuttādipūrite	សុវណ្ណរជតមណិមុត្តាទិបូរិតេ
suvaṇṇarasadhārābhisiñcamānā	សុវណ្ណរសធារាភិសិញ្ចមានា
suvaṇṇavaṇṇaṃ	សុវណ្ណវណ្ណំ
suvaṇṇāliṅgasadisaṃ	សុវណ្ណាលិង្គសទិសំ
suvaṇṇāliṅgaṃ	សុវណ្ណាលិង្គំ
suvisodhitaṃ	សុវិសោធិតំ
suvuttato	សុវុត្តតោ
suññā	សុញ្ញា
sve	ស្វេ
svāhaṃ	ស្វាហំ
svātanāya	ស្វាតនាយ
sā	សា
sādhakāni	សាធកានិ
sādhentā	សាធេន្តា
sādhu	សាធុ
sādhukāraṃ	សាធុការំ
sādhāraṇabhāvo	សាធារណភាវោ
sādhāraṇatāya	សាធារណតាយ
sādhūti	សាធូតិ
sāgaresu	សាគរេសុ
sāgaro	សាគរោ
sāgarā	សាគរា
sākhāpalāsasadisā	សាខាបលាសសទិសា
sālakalyāṇī	សាលកល្យាណី
sālarukkho	សាលរុក្ខោ
sālarājāva	សាលរាជាវ
sālo	សាលោ
sālāpi	សាលាបិ
sāmaññaṃ	សាមញ្ញំ
sāmikā	សាមិកា
sāmukkaṃsikena	សាមុក្កំសិកេន
sāmā	សាមា
sāragavesīti	សារគវេសីតិ
sārarukkho	សាររុក្ខោ
sārasūciṃ	សារសូចិំ
sāratthiko	សារត្ថិកោ
sāriputta	សារិបុត្ត
sāriputtassa	សារិបុត្តស្ស
sāriputtattherappabhavo	សារិបុត្តត្ថេរប្បភវោ
sāriputtattheravatthu	សារិបុត្តត្ថេរវត្ថុ
sāriputtatthero	សារិបុត្តត្ថេរោ
sāriputtāti	សារិបុត្តាតិ
sāropamaṃ	សារោបមំ
sāruppabhāvo	សារុប្បភាវោ
sāsanato	សាសនតោ
sāsanaṃ	សាសនំ
sāsane	សាសនេ
sāsitāti	សាសិតាតិ
sātisāro	សាតិសារោ
sāvakabhāsitattā	សាវកភាសិតត្តា
sāvakasannipātesu	សាវកសន្និបាតេសុ
sāvakasannipāto	សាវកសន្និបាតោ
sāvakasannipātā	សាវកសន្និបាតា
sāvako	សាវកោ
sāvakā	សាវកា
sāvikā	សាវិកា
sāvitoti	សាវិតោតិ
sāyanhasamayaṃ	សាយន្ហសមយំ
sāyanhasamaye	សាយន្ហសមយេ
sāyaṃ	សាយំ
sāṭakasmiṃ	សាដកស្មិំ
sāṭakayugaṃ	សាដកយុគំ
sāṭakaṃ	សាដកំ
sāṭṭhakathānaṃ	សាដ្ឋកថានំ
sīhanādaṃ	សីហនាទំ
sīhassa	សីហស្ស
sīhaṃ	សីហំ
sīho	សីហោ
sīlakkhandhādipāripūriṃyeva	សីលក្ខន្ធាទិបារិបូរិំយេវ
sīlapāramitā	សីលបារមិតា
sīlapāramitāya	សីលបារមិតាយ
sīlapāramiṃ	សីលបារមិំ
sīlapāramīti	សីលបារមីតិ
sīlasampadaṃ	សីលសម្បទំ
sīlassa	សីលស្ស
sīlavanāgarājakāle	សីលវនាគរាជកាលេ
sīlaṃ	សីលំ
sīle	សីលេ
sīlesu	សីលេសុ
sīlāni	សីលានិ
sīsakahāpaṇādīni	សីសកហាបណាទីនិ
sīsaṃ	សីសំ
sīsenādāya	សីសេនាទាយ
sītalaṃ	សីតលំ
sītena	សីតេន
sītuṇhapaṭighātena	សីតុណ្ហបដិឃាតេន
sīvalā	សីវលា
sīvalī	សីវលី
sūcanato	សូចនតោ
sūceti	សូចេតិ
sūdanato	សូទនតោ
sūriyappabhā	សូរិយប្បភា
sūriye	សូរិយេ
sūriyo	សូរិយោ
sūriyuggamanaṃ	សូរិយុគ្គមនំ
sūriyuggamane	សូរិយុគ្គមនេ
sūriyālokena	សូរិយាលោកេន
tacchakānaṃ	តច្ឆកានំ
tadatthajotikā	តទត្ថជោតិកា
tadaṅgappahānaṃ	តទង្គប្បហានំ
tadupasammanti	តទុបសម្មន្តិ
tadā	តទា
tadādakkhiṃ	តទាទក្ខិំ
tadāti	តទាតិ
tamantarahitaṃ	តមន្តរហិតំ
tambapaṇṇinivāsinaṃ	តម្ពបណ្ណិនិវាសិនំ
tamenaṃ	តមេនំ
tamhā	តម្ហា
tampi	តម្បិ
tanti	តន្តិ
tantiatthassa	តន្តិអត្ថស្ស
tantinayānugaṃ	តន្តិនយានុគំ
tantiyo	តន្តិយោ
tantiyā	តន្តិយា
tanu	តនុ
tarantassa	តរន្តស្ស
tarantā	តរន្តា
tasitā	តសិតា
tasmiṃ	តស្មិំ
tasmiṃyeva	តស្មិំយេវ
tasmā	តស្មា
tassa	តស្ស
tassaṃ	តស្សំ
tasseva	តស្សេវ
tassuddāna	តស្សុទ្ទាន
tassupari	តស្សុបរិ
tassā	តស្សា
tassāyevattho	តស្សាយេវត្ថោ
tathā	តថា
tathāgatassa	តថាគតស្ស
tathāgatavacanaṃ	តថាគតវចនំ
tathāgataṃ	តថាគតំ
tathāgate	តថាគតេ
tathāgato	តថាគតោ
tathāgatoti	តថាគតោតិ
tathāhaṃ	តថាហំ
tathārūpaṃ	តថារូបំ
tathārūpo	តថារូបោ
tatiyasaṅgītikālā	តតិយសង្គីតិកាលា
tatiyaṃ	តតិយំ
tatiye	តតិយេ
tatiyo	តតិយោ
tatiyābhisamayo	តតិយាភិសមយោ
tato	តតោ
tattakampi	តត្តកម្បិ
tattha	តត្ថ
tattheva	តត្ថេវ
tatthāsuṃ	តត្ថាសុំ
tatthāti	តត្ថាតិ
tava	តវ
tavantike	តវន្តិកេ
tayo	តយោ
tayopi	តយោបិ
tayā	តយា
tañcassa	តញ្ចស្ស
tañhi	តញ្ហិ
taḷākassa	តឡាកស្ស
taḷākaṃ	តឡាកំ
taṃ	តំ
taṅkhaṇaññeva	តង្ខណញ្ញេវ
taṇhādiṭṭhisaṃkilesānaṃ	តណ្ហាទិដ្ឋិសំកិលេសានំ
taṇhānaṃ	តណ្ហានំ
taṇḍule	តណ្ឌុលេ
te	តេ
tehi	តេហិ
tejasā	តេជសា
temāsaṃ	តេមាសំ
tena	តេន
teneva	តេនេវ
tepajja	តេបជ្ជ
tepi	តេបិ
tepiṭakassa	តេបិដកស្ស
tesaṃ	តេសំ
tesaṃyeva	តេសំយេវ
tesu	តេសុ
tesveva	តេស្វេវ
thaddhavisamabhūmibhāgatā	ថទ្ធវិសមភូមិភាគតា
thaddhavisamatā	ថទ្ធវិសមតា
thambhesu	ថម្ភេសុ
thenetvā	ថេនេត្វា
theragā	ថេរគា
theragāthā	ថេរគាថា
therassa	ថេរស្ស
therehi	ថេរេហិ
therena	ថេរេន
thereneva	ថេរេនេវ
thero	ថេរោ
therova	ថេរោវ
therīgāthā	ថេរីគាថា
thokaṃ	ថោកំ
thoke	ថោកេ
thometvā	ថោមេត្វា
thomitā	ថោមិតា
thutappasattho	ថុតប្បសត្ថោ
thāmadassinā	ថាមទស្សិនា
thāmappattaṃ	ថាមប្បត្តំ
ti	តិ
ticīvarehi	តិចីវរេហិ
tidasālaye	តិទសាលយេ
tidhā	តិធា
tidivakkamo	តិទិវក្កមោ
tikacchedo	តិកច្ឆេទោ
tikadukabhājanaṃ	តិកទុកភាជនំ
tikadukapaṭṭhānaṃ	តិកទុកបដ្ឋានំ
tikadukañca	តិកទុកញ្ច
tikamātikā	តិកមាតិកា
tikapaṭṭhānaṃ	តិកបដ្ឋានំ
tikatikapaṭṭhānaṃ	តិកតិកបដ្ឋានំ
tike	តិកេ
tikesu	តិកេសុ
tikesuyeva	តិកេសុយេវ
tikicchake	តិកិច្ឆកេ
tikicchāpeti	តិកិច្ឆាបេតិ
tikkhattuṃ	តិក្ខត្តុំ
tikā	តិកា
timattabhāṇavāraṃ	តិមត្តភាណវារំ
timattabhāṇavāro	តិមត្តភាណវារោ
timirapiṅgalamahāmaccho	តិមិរបិង្គលមហាមច្ឆោ
tipiṭakadharo	តិបិដកធរោ
tippabhedameva	តិប្បភេទមេវ
tiracchānagatā	តិរច្ឆានគតា
tissabhūtitthero	តិស្សភូតិត្ថេរោ
tisso	តិស្សោ
tissā	តិស្សា
titthe	តិត្ថេ
titthiyā	តិត្ថិយា
titti	តិត្តិ
tivaggo	តិវគ្គោ
tividhaggi	តិវិធគ្គិ
tividhena	តិវិធេន
tividho	តិវិធោ
tiṃsabhikkhusahassāni	តិំសភិក្ខុសហស្សានិ
tiṃsahatthubbedhaṃ	តិំសហត្ថុព្ពេធំ
tiṃsakappasahassamatthake	តិំសកប្បសហស្សមត្ថកេ
tiṃsavassasahassāni	តិំសវស្សសហស្សានិ
tiṇhena	តិណ្ហេន
tiṇāni	តិណានិ
tiṇṇampi	តិណ្ណម្បិ
tiṇṇaṃ	តិណ្ណំ
tiṇṇena	តិណ្ណេន
tiṭṭhamāno	តិដ្ឋមានោ
tiṭṭhati	តិដ្ឋតិ
tosayanto	តោសយន្តោ
tulābhūto	តុលាភូតោ
tulābhūtā	តុលាភូតា
tumhe	តុម្ហេ
tumhādise	តុម្ហាទិសេ
tunnaṃ	តុន្នំ
turiyehi	តុរិយេហិ
turiyā	តុរិយា
tusitabhavane	តុសិតភវនេ
tusitapurā	តុសិតបុរា
tusite	តុសិតេ
tusitā	តុសិតា
tuvaṃ	តុវំ
tuyhaṃ	តុយ្ហំ
tuṭṭhahaṭṭhaṃ	តុដ្ឋហដ្ឋំ
tuṭṭhamānasā	តុដ្ឋមានសា
tuṭṭhi	តុដ្ឋិ
tuṭṭhiñca	តុដ្ឋិញ្ច
tuṭṭhiṃ	តុដ្ឋិំ
tuṭṭho	តុដ្ឋោ
tvampi	ត្វម្បិ
tvaṃ	ត្វំ
tā	តា
tādihi	តាទិហិ
tādisaṃ	តាទិសំ
tāni	តានិ
tāpasapabbajjaṃ	តាបសបព្ពជ្ជំ
tāpasapabbajjāya	តាបសបព្ពជ្ជាយ
tāpasaparikkhāre	តាបសបរិក្ខារេ
tāpasaṃ	តាបសំ
tāpaso	តាបសោ
tāpena	តាបេន
tārakarūpappabhā	តារករូបប្បភា
tārakarūpesu	តារករូបេសុ
tārakarūpāni	តារករូបានិ
tārakā	តារកា
tārayanto	តារយន្តោ
tārayati	តារយតិ
tāremi	តារេមិ
tāresi	តារេសិ
tāsañca	តាសញ្ច
tāsaṃ	តាសំ
tāsaṃyeva	តាសំយេវ
tāta	តាត
tātāti	តាតាតិ
tāva	តាវ
tāvade	តាវទេ
tāvadeva	តាវទេវ
tāvatiṃsabhavane	តាវតិំសភវនេ
tāvatiṃse	តាវតិំសេ
tāvatiṃsesu	តាវតិំសេសុ
tāvatiṃsānaṃ	តាវតិំសានំ
tāvimaṃ	តាវិមំ
tāya	តាយ
tāyati	តាយតិ
tīhi	តីហិ
tīramhi	តីរម្ហិ
tīre	តីរេ
tīsu	តីសុ
tīṇi	តីណិ
tīṇisatasahassāni	តីណិសតសហស្សានិ
tūriyassa	តូរិយស្ស
ubbhijji	ឧព្ភិជ្ជិ
ubhato	ឧភតោ
ubhatobyañjanapaṇḍakā	ឧភតោព្យញ្ជនបណ្ឌកា
ubhatovibhaṅganiddesakhandhakaparivārā	ឧភតោវិភង្គនិទ្ទេសខន្ធកបរិវារា
ubhayanidānasampannassa	ឧភយនិទានសម្បន្នស្ស
ubhayāni	ឧភយានិ
ubho	ឧភោ
ubhopete	ឧភោបេតេ
ubhosu	ឧភោសុ
ucchuyantaṃva	ឧច្ឆុយន្តំវ
uccāraṭṭhānamhi	ឧច្ចារដ្ឋានម្ហិ
udagāhiniṃ	ឧទគាហិនិំ
udakacāṭiyo	ឧទកចាដិយោ
udakapariyantaṃ	ឧទកបរិយន្តំ
udakassa	ឧទកស្ស
udakañca	ឧទកញ្ច
udakaṃ	ឧទកំ
udapādi	ឧទបាទិ
udayo	ឧទយោ
uddesamaggo	ឧទ្ទេសមគ្គោ
uddesaṃ	ឧទ្ទេសំ
uddhanesu	ឧទ្ធនេសុ
uddhaṃ	ឧទ្ធំ
uddānasaṅgahavaggasaṅgahapeyyālasaṅgahaekanipātadukanipātādinipātasaṅgahasaṃyuttasaṅgaha	ឧទ្ទានសង្គហវគ្គសង្គហបេយ្យាលសង្គហឯកនិបាតទុកនិបាតាទិនិបាតសង្គហសំយុត្តសង្គហ
udeno	ឧទេនោ
udumbararukkho	ឧទុម្ពររុក្ខោ
udā	ឧទា
udāharaṇaṃ	ឧទាហរណំ
udāharituṃ	ឧទាហរិតុំ
udāhu	ឧទាហុ
udāna	ឧទាន
udānaṃ	ឧទានំ
udānesi	ឧទានេសិ
uggahetvā	ឧគ្គហេត្វា
uggahitanti	ឧគ្គហិតន្តិ
uggahitaṃ	ឧគ្គហិតំ
uggantvāpi	ឧគ្គន្ត្វាបិ
uggatejo	ឧគ្គតេជោ
uggato	ឧគ្គតោ
uggatāpanaṃ	ឧគ្គតាបនំ
uggatāpano	ឧគ្គតាបនោ
uggaṇhantopi	ឧគ្គណ្ហន្តោបិ
uggaṇhi	ឧគ្គណ្ហិ
uggaṇhitvā	ឧគ្គណ្ហិត្វា
uggiramānaṃ	ឧគ្គិរមានំ
ukkhaliyādīni	ឧក្ខលិយាទីនិ
ukkhepanīyakammatajjanīyakammāraho	ឧក្ខេបនីយកម្មតជ្ជនីយកម្មារហោ
ukkhipanti	ឧក្ខិបន្តិ
ummādassa	ឧម្មាទស្ស
umāpupphanīluppaladalasañchannaṃ	ឧមាបុប្ផនីលុប្បលទលសញ្ឆន្នំ
unnāmetvā	ឧន្នាមេត្វា
upaccagā	ឧបច្ចគា
upacālā	ឧបចាលា
upadduto	ឧបទ្ទុតោ
upadhārento	ឧបធារេន្តោ
upagamanamattameva	ឧបគមនមត្តមេវ
upagantvāna	ឧបគន្ត្វាន
upagataṃ	ឧបគតំ
upahāraṃ	ឧបហារំ
upakaraṇesu	ឧបករណេសុ
upakena	ឧបកេន
upakārāya	ឧបការាយ
upalabbhati	ឧបលព្ភតិ
upanidhāyahaṃ	ឧបនិធាយហំ
upanissayapaccayo	ឧបនិស្សយបច្ចយោ
upanissayaṃ	ឧបនិស្សយំ
upaparikkhanti	ឧបបរិក្ខន្តិ
upapatti	ឧបបត្តិ
upari	ឧបរិ
upariniggatāhi	ឧបរិនិគ្គតាហិ
uparitale	ឧបរិតលេ
upasammati	ឧបសម្មតិ
upasampādento	ឧបសម្បាទេន្តោ
upasanto	ឧបសន្តោ
upasaṅkamitvā	ឧបសង្កមិត្វា
upasaṅkamma	ឧបសង្កម្ម
upasobhati	ឧបសោភតិ
upasoṇā	ឧបសោណា
upasālo	ឧបសាលោ
upatisso	ឧបតិស្សោ
upatissā	ឧបតិស្សា
upaṭṭhahanti	ឧបដ្ឋហន្តិ
upaṭṭhissatimaṃ	ឧបដ្ឋិស្សតិមំ
upaṭṭhāko	ឧបដ្ឋាកោ
upaṭṭhānaṃ	ឧបដ្ឋានំ
upaṭṭhātiyeva	ឧបដ្ឋាតិយេវ
upekkhanaṃ	ឧបេក្ខនំ
upekkhāpāramitā	ឧបេក្ខាបារមិតា
upekkhāpāramiṃ	ឧបេក្ខាបារមិំ
upetaṃ	ឧបេតំ
uppajja	ឧប្បជ្ជ
uppajjanabhāvo	ឧប្បជ្ជនភាវោ
uppajjantāpi	ឧប្បជ្ជន្តាបិ
uppajjati	ឧប្បជ្ជតិ
uppajji	ឧប្បជ្ជិ
uppajjitvā	ឧប្បជ្ជិត្វា
uppalavaṇṇā	ឧប្បលវណ្ណា
uppannesu	ឧប្បន្នេសុ
uppannoti	ឧប្បន្នោតិ
uppannā	ឧប្បន្នា
uppattiyā	ឧប្បត្តិយា
uppādanatthāya	ឧប្បាទនត្ថាយ
uppādentesupi	ឧប្បាទេន្តេសុបិ
uppādetuṃ	ឧប្បាទេតុំ
uppādetvā	ឧប្បាទេត្វា
uppāṭetvā	ឧប្បាដេត្វា
upādinnakaphassādīsu	ឧបាទិន្នកផស្សាទីសុ
upādinnakasarīraṃ	ឧបាទិន្នកសរីរំ
upādāya	ឧបាទាយ
upāgantvā	ឧបាគន្ត្វា
upāgatosmīti	ឧបាគតោស្មីតិ
upārambhādihetu	ឧបារម្ភាទិហេតុ
upārambhānisaṃsā	ឧបារម្ភានិសំសា
upāyena	ឧបាយេន
uragādike	ឧរគាទិកេ
uruveḷā	ឧរុវេឡា
ussāhajāto	ឧស្សាហជាតោ
ussāhaṃ	ឧស្សាហំ
ussāhena	ឧស្សាហេន
ussāpento	ឧស្សាបេន្តោ
usumaṃ	ឧសុមំ
uttamapabbajjā	ឧត្តមបព្ពជ្ជា
uttarakuruṃ	ឧត្តរកុរុំ
uttaranti	ឧត្តរន្តិ
uttaraṃ	ឧត្តរំ
uttaripi	ឧត្តរិបិ
uttaro	ឧត្តរោ
uttarā	ឧត្តរា
uttarāsaṅgena	ឧត្តរាសង្គេន
uttasati	ឧត្តសតិ
uttiyo	ឧត្តិយោ
utuvasse	ឧតុវស្សេ
utuṃ	ឧតុំ
utūnaṃ	ឧតូនំ
uyyojesi	ឧយ្យោជេសិ
uyyojetabbo	ឧយ្យោជេតព្ពោ
uyyānakīḷāya	ឧយ្យានកីឡាយ
uyyānavimānakapparukkhesu	ឧយ្យានវិមានកប្បរុក្ខេសុ
uyyānaṃ	ឧយ្យានំ
uṇhabhāvaṃ	ឧណ្ហភាវំ
uṇhañca	ឧណ្ហញ្ច
uṇhaṃ	ឧណ្ហំ
uṇhe	ឧណ្ហេ
uṭṭhahanti	ឧដ្ឋហន្តិ
uṭṭhahantūti	ឧដ្ឋហន្តូតិ
uṭṭhahatūti	ឧដ្ឋហតូតិ
uṭṭhahi	ឧដ្ឋហិ
uṭṭhahiṃsu	ឧដ្ឋហិំសុ
uṭṭhāpanīyabhāvo	ឧដ្ឋាបនីយភាវោ
uṭṭhāpetvā	ឧដ្ឋាបេត្វា
uṭṭhāyāsanā	ឧដ្ឋាយាសនា
va	វ
vacana	វចន
vacanamabrvi	វចនមព្រ្វិ
vacanatthakosallatthaṃ	វចនត្ថកោសល្លត្ថំ
vacanattho	វចនត្ថោ
vacanaṃ	វចនំ
vacanesu	វចនេសុ
vaccaṃ	វច្ចំ
vacībhedaṃ	វចីភេទំ
vadanti	វទន្តិ
vadati	វទតិ
vadesīti	វទេសីតិ
vadeyya	វទេយ្យ
vadāmīti	វទាមីតិ
vajjanti	វជ្ជន្តិ
vajjayantā	វជ្ជយន្តា
vanasaṇḍe	វនសណ្ឌេ
vandissatīti	វន្ទិស្សតីតិ
vandissāmīti	វន្ទិស្សាមីតិ
vanditvā	វន្ទិត្វា
vapayanti	វបយន្តិ
varagandhañca	វរគន្ធញ្ច
varasamāpattiyo	វរសមាបត្តិយោ
varasāṭakayugaṃ	វរសាដកយុគំ
varuṇo	វរុណោ
vasanaṭṭhānaṃ	វសនដ្ឋានំ
vasantassa	វសន្តស្ស
vasante	វសន្តេ
vasantena	វសន្តេន
vasanto	វសន្តោ
vasena	វសេន
vasi	វសិ
vasitvā	វសិត្វា
vassasahassaṃ	វស្សសហស្សំ
vassasahassenapi	វស្សសហស្សេនបិ
vassasahassānaṃ	វស្សសហស្សានំ
vassasahassāni	វស្សសហស្សានិ
vassasahassānīti	វស្សសហស្សានីតិ
vassasatasahassanti	វស្សសតសហស្សន្តិ
vassasatasahassaṃ	វស្សសតសហស្សំ
vassasatasahassenapi	វស្សសតសហស្សេនបិ
vassasatasahassānaṃ	វស្សសតសហស្សានំ
vassasataṃ	វស្សសតំ
vassasatenapi	វស្សសតេនបិ
vassasatānaṃ	វស្សសតានំ
vassasatāni	វស្សសតានិ
vassāni	វស្សានិ
vasudhā	វសុធា
vasībhūtassa	វសីភូតស្ស
vasīgaṇena	វសីគណេន
vasīhiṭṭhakathā	វសីហិដ្ឋកថា
vata	វត
vatamadhiṭṭhahinti	វតមធិដ្ឋហិន្តិ
vataṃ	វតំ
vattabbaṃ	វត្តព្ពំ
vattabbe	វត្តព្ពេ
vattabbo	វត្តព្ពោ
vattamānā	វត្តមានា
vattanti	វត្តន្តិ
vattasampattiyā	វត្តសម្បត្តិយា
vattati	វត្តតិ
vattaṃ	វត្តំ
vatthu	វត្ថុ
vatthupi	វត្ថុបិ
vatthurūpaṃ	វត្ថុរូបំ
vatthāni	វត្ថានិ
vattā	វត្តា
vatvā	វត្វា
vavatthapetvāva	វវត្ថបេត្វាវ
vavatthāpitāya	វវត្ថាបិតាយ
vayadhammā	វយធម្មា
vaḍḍhakivaṇṇaṃ	វឌ្ឍកិវណ្ណំ
vaḍḍhati	វឌ្ឍតិ
vaḍḍheti	វឌ្ឍេតិ
vaḍḍhetvā	វឌ្ឍេត្វា
vaḷañjanaṃ	វឡញ្ជនំ
vaṃ	វំ
vaṃsānurakkhaṇatthāya	វំសានុរក្ខណត្ថាយ
vaṅkakājaṃ	វង្កកាជំ
vaṅkapabbatasadise	វង្កបព្ពតសទិសេ
vaṇṇadhātu	វណ្ណធាតុ
vaṇṇapokkharatāya	វណ្ណបោក្ខរតាយ
vaṇṇaṃ	វណ្ណំ
vaṇṇenātiādīsu	វណ្ណេនាតិអាទីសុ
vaṇṇitā	វណ្ណិតា
vaṭumāyanaṃ	វដុមាយនំ
vaṭṭati	វដ្ដតិ
vaṭṭatīti	វដ្ដតីតិ
ve	វេ
vebhārapabbate	វេភារបព្ពតេ
vebhāraṃ	វេភារំ
vedajāto	វេទជាតោ
vedalla	វេទល្ល
vedallanti	វេទល្លន្តិ
vedallaṃ	វេទល្លំ
vedanā	វេទនា
vedanākkhandhavaseneva	វេទនាក្ខន្ធវសេនេវ
vedanāpañcakaindriyavasena	វេទនាបញ្ចកឥន្ទ្រិយវសេន
vedanāsatipaṭṭhānavaseneva	វេទនាសតិបដ្ឋានវសេនេវ
vedanāttikavaseneva	វេទនាត្តិកវសេនេវ
vedanāvasena	វេទនាវសេន
vedanāvaseneva	វេទនាវសេនេវ
vedañca	វេទញ្ច
vedehamuninā	វេទេហមុនិនា
veditabbaṃ	វេទិតព្ពំ
veditabbo	វេទិតព្ពោ
veditabbā	វេទិតព្ពា
vedāna	វេទាន
vedānaṃ	វេទានំ
vegena	វេគេន
vehapphale	វេហប្ផលេ
vehāsaṃ	វេហាសំ
velante	វេលន្តេ
velantena	វេលន្តេន
velāya	វេលាយ
veneyyajjhāsayānulomena	វេនេយ្យជ្ឈាសយានុលោមេន
vesaṃ	វេសំ
vessabhū	វេស្សភូ
vessantararājakāleti	វេស្សន្តររាជកាលេតិ
vessantarasadise	វេស្សន្តរសទិសេ
vessantarattabhāve	វេស្សន្តរត្តភាវេ
vessantarattabhāvā	វេស្សន្តរត្តភាវា
vesārajjaññāṇaṃ	វេសារជ្ជញ្ញាណំ
vevaṇṇiyaṃ	វេវណ្ណិយំ
veyyākaraṇa	វេយ្យាករណ
veyyākaraṇaṃ	វេយ្យាករណំ
veṭhāpetvā	វេឋាបេត្វា
vi	វិ
vibha	វិភ
vibhajanto	វិភជន្តោ
vibhajitvā	វិភជិត្វា
vibhattaṃ	វិភត្តំ
vibhattiyo	វិភត្តិយោ
vibhatto	វិភត្តោ
vibhattā	វិភត្តា
vibhavopi	វិភវោបិ
vibhaṅgappakaraṇaṃ	វិភង្គប្បករណំ
vibhaṅgā	វិភង្គា
vibhāvanā	វិភាវនា
vibhāvaye	វិភាវយេ
vibhāvayeti	វិភាវយេតិ
vibhūsanaṭṭhānabhāvo	វិភូសនដ្ឋានភាវោ
vibhūsanaṭṭhānābhāvo	វិភូសនដ្ឋានាភាវោ
vicakkhaṇe	វិចក្ខណេ
vicarantaṃ	វិចរន្តំ
vicaraṇaṃ	វិចរណំ
vicariṃsu	វិចរិំសុ
vicinanto	វិចិនន្តោ
vicinantohaṃ	វិចិនន្តោហំ
vicinissāmi	វិចិនិស្សាមិ
vicinitvā	វិចិនិត្វា
vicintesiṃ	វិចិន្តេសិំ
vicināmi	វិចិនាមិ
vicito	វិចិតោ
vicittattharaṇavaṇṇo	វិចិត្តត្ថរណវណ្ណោ
viddhaṃsetvā	វិទ្ធំសេត្វា
viddhaṃsiyanti	វិទ្ធំសិយន្តិ
vidhamitvā	វិធមិត្វា
vidhurapaṇḍitakāle	វិធុរបណ្ឌិតកាលេ
vidhuro	វិធុរោ
vidhāvati	វិធាវតិ
vigatapaccayo	វិគតបច្ចយោ
vigatā	វិគតា
vighāsādo	វិឃាសាទោ
vighātassa	វិឃាតស្ស
viharati	វិហរតិ
viharatītiādinā	វិហរតីតិអាទិនា
viharāmi	វិហរាមិ
vihāraṃ	វិហារំ
vihārena	វិហារេន
vihāsi	វិហាសិ
vihāsinti	វិហាសិន្តិ
vihāsīti	វិហាសីតិ
vijahatīti	វិជហតីតិ
vijitaṃ	វិជិតំ
vijitāvī	វិជិតាវី
vijjamāne	វិជ្ជមានេ
vijjante	វិជ្ជន្តេ
vijjati	វិជ្ជតិ
vijjhiyanto	វិជ្ឈិយន្តោ
vijjā	វិជ្ជា
vijjābhāgino	វិជ្ជាភាគិនោ
vijjāttayachaḷabhiññācatupaṭisambhidāppabhedaṃ	វិជ្ជាត្តយឆឡភិញ្ញាចតុបដិសម្ភិទាប្បភេទំ
vijjāyo	វិជ្ជាយោ
vijānāma	វិជានាម
vikiriyanti	វិកិរិយន្តិ
vikkhambhanasamucchedappahānāni	វិក្ខម្ភនសមុច្ឆេទប្បហានានិ
vikkhambhetvā	វិក្ខម្ភេត្វា
vikopeti	វិកោបេតិ
viloketvā	វិលោកេត្វា
vimalehi	វិមលេហិ
vimuccissatīti	វិមុច្ចិស្សតីតិ
vinassati	វិនស្សតិ
vinassatu	វិនស្សតុ
vinayanato	វិនយនតោ
vinayapiṭakaṃ	វិនយបិដកំ
vinayapiṭake	វិនយបិដកេ
vinayatantiṃ	វិនយតន្តិំ
vinayaṃ	វិនយំ
vinaye	វិនយេ
vinayo	វិនយោ
vinayoti	វិនយោតិ
vinayādayo	វិនយាទយោ
vindituṃ	វិន្ទិតុំ
vineti	វិនេតិ
vinetuṃ	វិនេតុំ
vinicchayaṃ	វិនិច្ឆយំ
vinivijjhitvā	វិនិវិជ្ឈិត្វា
vinodehi	វិនោទេហិ
vināyake	វិនាយកេ
vināyako	វិនាយកោ
vipajjati	វិបជ្ជតិ
vipassanaṃ	វិបស្សនំ
vipassanā	វិបស្សនា
vipassanābalassa	វិបស្សនាពលស្ស
vipassanābalaṃ	វិបស្សនាពលំ
vipassī	វិបស្សី
vipattiñcāpi	វិបត្តិញ្ចាបិ
vipattiṃ	វិបត្តិំ
vippakāraṃ	វិប្បការំ
vippayogo	វិប្បយោគោ
vippayuttapaccayo	វិប្បយុត្តបច្ចយោ
vippayuttaṃ	វិប្បយុត្តំ
vippayuttena	វិប្បយុត្តេន
vipulo	វិបុលោ
vipulā	វិបុលា
vipākantaraṃ	វិបាកន្តរំ
vipākapaccayo	វិបាកបច្ចយោ
vipākato	វិបាកតោ
virajjhissāma	វិរជ្ឈិស្សាម
virajjhiya	វិរជ្ឈិយ
viroca	វិរោច
virocanti	វិរោចន្តិ
virocati	វិរោចតិ
virocittha	វិរោចិត្ថ
virocituṃ	វិរោចិតុំ
virociṃsu	វិរោចិំសុ
visayhaseṭṭhikāle	វិសយ្ហសេដ្ឋិកាលេ
visayo	វិសយោ
visayoti	វិសយោតិ
visaṃvādeti	វិសំវាទេតិ
visaṃyuttā	វិសំយុត្តា
visaṅkhataṃ	វិសង្ខតំ
visesabhūtā	វិសេសភូតា
visesanayattā	វិសេសនយត្តា
visesavantataro	វិសេសវន្តតរោ
visesavaṇṇasaṇṭhānañca	វិសេសវណ្ណសណ្ឋានញ្ច
visesena	វិសេសេន
vissajjanañca	វិស្សជ្ជនញ្ច
vissajjanaṃ	វិស្សជ្ជនំ
vissajjenti	វិស្សជ្ជេន្តិ
vissajjetvā	វិស្សជ្ជេត្វា
vissakammadevaputtaṃ	វិស្សកម្មទេវបុត្តំ
vissakammadevaputte	វិស្សកម្មទេវបុត្តេ
vissakammanimmitaṃ	វិស្សកម្មនិម្មិតំ
vissakammena	វិស្សកម្មេន
visākhā	វិសាខា
visākhāpuṇṇamadivase	វិសាខាបុណ្ណមទិវសេ
visākhāpuṇṇamāsiyaṃ	វិសាខាបុណ្ណមាសិយំ
vitakkavūpasamanatthaṃ	វិតក្កវូបសមនត្ថំ
vitakkaṃ	វិតក្កំ
vitthārato	វិត្ថារតោ
vitthārena	វិត្ថារេន
vitthārikaṃ	វិត្ថារិកំ
vitthāritasuttesupi	វិត្ថារិតសុត្តេសុបិ
vitthāriyamānaṃ	វិត្ថារិយមានំ
vitthāriyamāno	វិត្ថារិយមានោ
vitthāriyamānā	វិត្ថារិយមានា
vitthāro	វិត្ថារោ
vivajjantu	វិវជ្ជន្តុ
vivajjento	វិវជ្ជេន្តោ
vivaritvā	វិវរិត្វា
vivaṇṇetukāmo	វិវណ្ណេតុកាមោ
vivaṭamatte	វិវដមត្តេ
vividhanayattā	វិវិធនយត្តា
viya	វិយ
viyākaṃsu	វិយាកំសុ
viyāti	វិយាតិ
viññūnaṃ	វិញ្ញូនំ
vo	វោ
vohārabāhullato	វោហារពាហុល្លតោ
vohāradesanā	វោហារទេសនា
vohārakusalena	វោហារកុសលេន
vokkamasi	វោក្កមសិ
vokkamati	វោក្កមតិ
vuccanti	វុច្ចន្តិ
vuccati	វុច្ចតិ
vudakaṃ	វុទកំ
vuttadhammānaṃ	វុត្តធម្មានំ
vuttanayena	វុត្តនយេន
vuttatthā	វុត្តត្ថា
vuttattā	វុត្តត្តា
vuttavacanaṃ	វុត្តវចនំ
vuttañhetaṃ	វុត្តញ្ហេតំ
vuttaṃ	វុត្តំ
vutte	វុត្តេ
vuttoyeva	វុត្តោយេវ
vuttā	វុត្តា
vuḍḍhilakkhaṇapūjitaparicchinnādhikesu	វុឌ្ឍិលក្ខណបូជិតបរិច្ឆិន្នាធិកេសុ
vuḍḍhimanto	វុឌ្ឍិមន្តោ
vuḍḍhimantopi	វុឌ្ឍិមន្តោបិ
vuḍḍhiyaṃ	វុឌ្ឍិយំ
vuṭṭhahantassa	វុដ្ឋហន្តស្ស
vuṭṭhahiṃ	វុដ្ឋហិំ
vuṭṭhito	វុដ្ឋិតោ
vuṭṭhāpiyamānassa	វុដ្ឋាបិយមានស្ស
vuṭṭhāya	វុដ្ឋាយ
vā	វា
vācanāmaggato	វាចនាមគ្គតោ
vācanāmaggo	វាចនាមគ្គោ
vācañca	វាចញ្ច
vāceti	វាចេតិ
vācetuñca	វាចេតុញ្ច
vācetvā	វាចេត្វា
vādayutti	វាទយុត្តិ
vādaṃ	វាទំ
vākacīrasmiñhi	វាកចីរស្មិញ្ហិ
vākacīrañca	វាកចីរញ្ច
vākacīraṃ	វាកចីរំ
vākacīre	វាកចីរេ
vākacīrāni	វាកចីរានិ
vākuppattiyā	វាកុប្បត្តិយា
vāladhiṃ	វាលធិំ
vālaṃ	វាលំ
vāpitaṃ	វាបិតំ
vāsipharasuhattho	វាសិផរសុហត្ថោ
vāsiṭṭho	វាសិដ្ឋោ
vātaṃ	វាតំ
vātiādinā	វាតិអាទិនា
vāto	វាតោ
vāyamantassāpissa	វាយមន្តស្សាបិស្ស
vāyamanto	វាយមន្តោ
vāyanti	វាយន្តិ
vāyati	វាយតិ
vīriyapāramitā	វីរិយបារមិតា
vīriyapāramitādīnampi	វីរិយបារមិតាទីនម្បិ
vīriyapāramiṃ	វីរិយបារមិំ
vīriyapāramīti	វីរិយបារមីតិ
vīriyaṃ	វីរិយំ
vīsabhāṇavārasataṃ	វីសភាណវារសតំ
vīsatibhikkhusahassāni	វីសតិភិក្ខុសហស្សានិ
vīsatihatthubbedhaṃ	វីសតិហត្ថុព្ពេធំ
vīsativassasahassāni	វីសតិវស្សសហស្សានិ
vītamalā	វីតមលា
vītarāgā	វីតរាគា
vīthito	វីថិតោ
vītikkamapaṭipakkhattā	វីតិក្កមបដិបក្ខត្តា
vītikkamappahānaṃ	វីតិក្កមប្បហានំ
vītikkame	វីតិក្កមេ
vītināmesi	វីតិនាមេសិ
vītināmetvā	វីតិនាមេត្វា
vītipatantamaṇitālavaṇṭaṃ	វីតិបតន្តមណិតាលវណ្ដំ
vītipatantarajatatālavaṇṭā	វីតិបតន្តរជតតាលវណ្ដា
vītivattāni	វីតិវត្តានិ
yadi	យទិ
yahiṃ	យហិំ
yakkhasenāpati	យក្ខសេនាបតិ
yakkhaṃ	យក្ខំ
yakkho	យក្ខោ
yakkhānaṃ	យក្ខានំ
yamakappakaraṇaṃ	យមកប្បករណំ
yamakapāṭihāriyaṃ	យមកបាដិហារិយំ
yamakapāṭihāriye	យមកបាដិហារិយេ
yamakaṃ	យមកំ
yasavatī	យសវតី
yasavā	យសវា
yasmā	យស្មា
yaso	យសោ
yasodharā	យសោធរា
yassa	យស្ស
yassāyaṃ	យស្សាយំ
yathayidaṃ	យថយិទំ
yathicchitaṃ	យថិច្ឆិតំ
yathā	យថា
yathābhūtāvabodho	យថាភូតាវពោធោ
yathādhammasāsana	យថាធម្មសាសន
yathādhammaṃ	យថាធម្មំ
yathākkamaṃ	យថាក្កមំ
yathākkamena	យថាក្កមេន
yathānisinnova	យថានិសិន្នោវ
yathānulomasāsanaṃ	យថានុលោមសាសនំ
yathānulomaṃ	យថានុលោមំ
yathāparādhasāsanaṃ	យថាបរាធសាសនំ
yathāparādhayathānulomayathādhammasāsanāni	យថាបរាធយថានុលោមយថាធម្មសាសនានិ
yathāparādhaṃ	យថាបរាធំ
yathārahaṃ	យថារហំ
yathāruci	យថារុចិ
yathāsukhaṃ	យថាសុខំ
yatonidānaṃ	យតោនិទានំ
yattha	យត្ថ
yañca	យញ្ច
yaññadatto	យញ្ញទត្តោ
yaṃ	យំ
yaṃkiñci	យំកិញ្ចិ
yaṃnūnāhaṃ	យំនូនាហំ
ye	យេ
yeme	យេមេ
yena	យេន
yenena	យេនេន
yesaṃ	យេសំ
yo	យោ
yogena	យោគេន
yojanamattaṃ	យោជនមត្តំ
yojanappamāṇaṃ	យោជនប្បមាណំ
yojanattayaṃ	យោជនត្តយំ
yojane	យោជនេ
yojanāni	យោជនានិ
yojetvā	យោជេត្វា
yugandhare	យុគន្ធរេ
yuttaṃ	យុត្តំ
yā	យា
yācake	យាចកេ
yācanti	យាចន្តិ
yāci	យាចិ
yācito	យាចិតោ
yāgubhattavatthādīni	យាគុភត្តវត្ថាទីនិ
yāme	យាមេ
yānake	យានកេ
yāni	យានិ
yāpanaṃ	យាបនំ
yāpesīti	យាបេសីតិ
yāsaṃ	យាសំ
yāva	យាវ
yāvajjatanakālā	យាវជ្ជតនកាលា
yāvatā	យាវតា
yāvatāyukaṃ	យាវតាយុកំ
Ñeyyadhammesu	ញេយ្យធម្មេសុ
Ñāṇavibhaṅgo	ញាណវិភង្គោ
ñatvā	ញត្វា
ñeyyā	ញេយ្យា
ñāpetabbo	ញាបេតព្ពោ
ñātisamāgame	ញាតិសមាគមេ
ñātisaṅghaparivuto	ញាតិសង្ឃបរិវុតោ
ñāṇabhūto	ញាណភូតោ
ñāṇanti	ញាណន្តិ
ñāṇassa	ញាណស្ស
ñāṇasāgaro	ញាណសាគរោ
ñāṇasāgaroti	ញាណសាគរោតិ
ñāṇavatthūtiādinā	ញាណវត្ថូតិអាទិនា
ñāṇavibhaṅgo	ញាណវិភង្គោ
ñāṇaṃ	ញាណំ
ñāṇena	ញាណេន
ñāṇuttarānaṃ	ញាណុត្តរានំ
Ābhatā	អាភតា
Ābhidhammikabhikkhūnampi	អាភិធម្មិកភិក្ខូនម្បិ
Ābhidhammikabhikkhūyeva	អាភិធម្មិកភិក្ខូយេវ
Ābhidhammikā	អាភិធម្មិកា
Āgacchanto	អាគច្ឆន្តោ
Āha	អាហ
Āhāramūlakassa	អាហារមូលកស្ស
Ājānāhi	អាជានាហិ
Ākāsaṭṭhā	អាកាសដ្ឋា
Āmantā	អាមន្តា
Āmoditā	អាមោទិតា
Ānandatthero	អានន្ទត្ថេរោ
Ānandattherādīhi	អានន្ទត្ថេរាទីហិ
Ānando	អានន្ទោ
Ānubhāvena	អានុភាវេន
Āropayitvā	អារោបយិត្វា
Ātāpino	អាតាបិនោ
Āyuppamāṇaṃ	អាយុប្បមាណំ
ābharaṇesu	អាភរណេសុ
ābhatassa	អាភតស្ស
ābhato	អាភតោ
ābhidhammikabhikkhūnaṃ	អាភិធម្មិកភិក្ខូនំ
ābhidhammikattherānaṃ	អាភិធម្មិកត្ថេរានំ
ābhidhammiko	អាភិធម្មិកោ
ābhidhammikā	អាភិធម្មិកា
ābhujati	អាភុជតិ
ābhujiṃ	អាភុជិំ
ābhāya	អាភាយ
ācariyaparamparāya	អាចរិយបរម្បរាយ
ācariyaṃ	អាចរិយំ
ācariyānaṃ	អាចរិយានំ
ācikkhati	អាចិក្ខតិ
ācikkhitvā	អាចិក្ខិត្វា
ācāraguṇasampanno	អាចារគុណសម្បន្នោ
ādayo	អាទយោ
ādhārakāni	អាធារកានិ
ādiccova	អាទិច្ចោវ
ādito	អាទិតោ
ādiyinti	អាទិយិន្តិ
ādiṃ	អាទិំ
ādāya	អាទាយ
ādīnavaṃ	អាទីនវំ
ādīnave	អាទីនវេ
ādīnavo	អាទីនវោ
ādīnavā	អាទីនវា
āgacchantaṃ	អាគច្ឆន្តំ
āgacchatūti	អាគច្ឆតូតិ
āgaccheyya	អាគច្ឆេយ្យ
āgamanatthāya	អាគមនត្ថាយ
āgamanaṃ	អាគមនំ
āgamaṭṭhakathāsupi	អាគមដ្ឋកថាសុបិ
āgametvā	អាគមេត្វា
āgami	អាគមិ
āgamiṃsu	អាគមិំសុ
āgamma	អាគម្ម
āgantvā	អាគន្ត្វា
āgatena	អាគតេន
āgato	អាគតោ
āha	អាហ
āhaccabhāsitā	អាហច្ចភាសិតា
āharasi	អាហរសិ
āharituṃ	អាហរិតុំ
āharitvā	អាហរិត្វា
āhariṃ	អាហរិំ
āharāpetvā	អាហរាបេត្វា
āhu	អាហុ
āhutīnaṃ	អាហុតីនំ
āhārapaccayo	អាហារបច្ចយោ
āhāraṃ	អាហារំ
ājānāmi	អាជានាមិ
ākappasampannā	អាកប្បសម្បន្នា
ākappo	អាកប្បោ
ākaḍḍhanto	អាកឌ្ឍន្តោ
ākaṅkhamānena	អាកង្ខមានេន
ākaṅkhamānā	អាកង្ខមានា
ākāsagaṅgā	អាកាសគង្គា
ākāsanabhagatā	អាកាសនភគតា
ākāsato	អាកាសតោ
ākāse	អាកាសេ
ākāsena	អាកាសេន
ālambanaphalakaṃ	អាលម្ពនផលកំ
ālayaṃ	អាលយំ
ālokapharaṇasamattho	អាលោកផរណសមត្ថោ
āloḷenti	អាលោឡេន្តិ
āloḷetvā	អាលោឡេត្វា
āmalakarukkho	អាមលករុក្ខោ
āmantayāmi	អាមន្តយាមិ
āmantesi	អាមន្តេសិ
āmantetvā	អាមន្តេត្វា
ānanda	អានន្ទ
ānandakumāro	អានន្ទកុមារោ
ānandetiādinayapavattā	អានន្ទេតិអាទិនយបវត្តា
ānando	អានន្ទោ
ānantarikehi	អានន្តរិកេហិ
ānisaṃse	អានិសំសេ
ānisaṃsehi	អានិសំសេហិ
ānisaṃso	អានិសំសោ
ānisaṃsā	អានិសំសា
ānubhāvena	អានុភាវេន
āpajjamāno	អាបជ្ជមានោ
āpajjatīti	អាបជ្ជតីតិ
āpannasattānaṃ	អាបន្នសត្តានំ
āpatti	អាបត្តិ
ārabhi	អារភិ
ārabhitvā	អារភិត្វា
āraddhavīriyo	អារទ្ធវីរិយោ
ārammaṇapaccayo	អារម្មណបច្ចយោ
ārammaṇapaccayope	អារម្មណបច្ចយោបេ
ārammaṇādīhi	អារម្មណាទីហិ
ārocento	អារោចេន្តោ
ārocetuṃ	អារោចេតុំ
ārocetvā	អារោចេត្វា
ārodanaparidevanaṃ	អារោទនបរិទេវនំ
āropetvā	អារោបេត្វា
āruppe	អារុប្បេ
āruyha	អារុយ្ហ
ārāmikakiccaṃ	អារាមិកកិច្ចំ
āsanā	អាសនា
āsanāni	អាសនានិ
āsavehi	អាសវេហិ
āsayā	អាសយា
āsevanapaccayo	អាសេវនបច្ចយោ
āsevitanisevitaṃ	អាសេវិតនិសេវិតំ
āsi	អាសិ
āsiñcamānakhīradhārāsamparikiṇṇā	អាសិញ្ចមានខីរធារាសម្បរិកិណ្ណា
āsiñcamānavilīnasuvaṇṇaṃ	អាសិញ្ចមានវិលីនសុវណ្ណំ
āsuṃ	អាសុំ
āsāḷhīpuṇṇamadivase	អាសាឡ្ហីបុណ្ណមទិវសេ
āvajjesi	អាវជ្ជេសិ
āvaraṇaṃ	អាវរណំ
āvibhāvatthaṃ	អាវិភាវត្ថំ
āvunantena	អាវុនន្តេន
āvuso	អាវុសោ
āvusoti	អាវុសោតិ
āvāsaṃ	អាវាសំ
āyapotthakaṃ	អាយបោត្ថកំ
āyasmanto	អាយស្មន្តោ
āyatanantaraṃ	អាយតនន្តរំ
āyatanapadeso	អាយតនបទេសោ
āyatanapaññatti	អាយតនបញ្ញត្តិ
āyatanavibhaṅgo	អាយតនវិភង្គោ
āyatanavibhaṅgādayopi	អាយតនវិភង្គាទយោបិ
āyatanayamakaṃ	អាយតនយមកំ
āyatanā	អាយតនា
āyu	អាយុ
āyukkhayaṃ	អាយុក្ខយំ
āyupariyosane	អាយុបរិយោសនេ
āyupariyosāne	អាយុបរិយោសានេ
āyuppamāṇanti	អាយុប្បមាណន្តិ
āyuppamāṇaṃ	អាយុប្បមាណំ
āyuvaṇṇaissariyayasasampattiādīhi	អាយុវណ្ណឥស្សរិយយសសម្បត្តិអាទីហិ
āyācitadhammadesano	អាយាចិតធម្មទេសនោ
āyācito	អាយាចិតោ
āyūti	អាយូតិ
āḷhakasahassehi	អាឡ្ហកសហស្សេហិ
āḷhakasatasahassehi	អាឡ្ហកសតសហស្សេហិ
āḷhakasatehi	អាឡ្ហកសតេហិ
āḷārañca	អាឡារញ្ច
āḷārudakānaṃ	អាឡារុទកានំ
āṇābāhullato	អាណាពាហុល្លតោ
āṇādesanā	អាណាទេសនា
āṇārahena	អាណារហេន
āṇāvohāraparamatthadesanā	អាណាវោហារបរមត្ថទេសនា
īdisaṃ	ឦទិសំ
īdiso	ឦទិសោ
ūkāmaṅgulagharagoḷikādīnaṃ	ឩកាមង្គុលឃរគោឡិកាទីនំ
ūmivegappabhedasamuggatajalacuṇṇaparikiṇṇo	ឩមិវេគប្បភេទសមុគ្គតជលចុណ្ណបរិកិណ្ណោ
ūmivego	ឩមិវេគោ
ḍaṃseyya	ឌំសេយ្យ
Ṭhapento	ឋបេន្តោ
Ṭhapetvā	ឋបេត្វា
ṭhapayitvā	ឋបយិត្វា
ṭhapento	ឋបេន្តោ
ṭhapesi	ឋបេសិ
ṭhapetabbatāya	ឋបេតព្ពតាយ
ṭhapetvā	ឋបេត្វា
ṭhapitamātikāya	ឋបិតមាតិកាយ
ṭhapitaṃ	ឋបិតំ
ṭhapitaṃyeva	ឋបិតំយេវ
ṭhapito	ឋបិតោ
ṭhapitā	ឋបិតា
ṭhatvā	ឋត្វា
ṭhatvāna	ឋត្វាន
ṭhitapadeneva	ឋិតបទេនេវ
ṭhitassa	ឋិតស្ស
ṭhitaṭṭhānassa	ឋិតដ្ឋានស្ស
ṭhito	ឋិតោ
ṭhitāni	ឋិតានិ
ṭhānampi	ឋានម្បិ
ṭhānaṃ	ឋានំ
ṭhāne	ឋានេ
ṭhānehi	ឋានេហិ
ṭhānesu	ឋានេសុ
ṭhānā	ឋានា